border_size=1
usage=map

Ce          , Ke          , Ce          , Gs^Fms      , Gs^Fp       , Gs^Fp       , Gg^Efm      , Gs^Fp       , Gg^Fet      , Gs^Fp       , Gs^Fp       , Gg^Efm      , Gg          , Gg          , Gg^Efm      , Gs^Fms      , Gg^Efm      , Gg^Efm      , Gg^Efm      , Gg^Efm      , Gg^Efm      , Hh          , Mm          , Mm          , Hh          , Chr         , Hh^Fdw      , Gg^Efm      , Gg^Efm      , Gg^Efm      , Wo          , Mm          , Mm          , Mm          , Mm          , Mm          , Hh^Fmw      , Hh          , Mm          , Ha^Vhha     , Mm^Xm       , Mm^Xm       , Mm          , Mm          
Gs^Fp       , Ce          , Gs^Fp       , Gs^Fms      , Gs^Fp       , Gs^Fp       , Gs^Fp       , Gs^Fms      , Gs^Fp       , Gs^Fms      , Gs^Fp       , Gg^Efm      , Gg^Efm      , Gg          , Gg^Efm      , Gs          , Gg^Efm      , Gg^Efm      , Gg^Efm      , Gg^Efm      , Gg^Efm      , Gs^Fp       , Hh^Fms      , Mm          , Mm          , Mm          , Hh          , Mm          , Hh          , Gg^Efm      , Mm          , Mm          , Mm          , Ha          , Mm          , Hh^Fmw      , Mm          , Mm          , Mm          , Mm          , Mm^Xm       , Mm^Xm       , Ms          , Mm          
Gs^Fp       , Gs^Fp       , Gs^Fp       , Gs^Fp       , Gs^Fp       , Gs^Fp       , Gs^Fms      , Gg^Efm      , Gg^Efm      , Gs^Fp       , Gs^Fp       , Gs^Fp       , Gg^Efm      , Gg^Efm      , Gg^Efm      , Gg          , Gg          , Gg          , Gg          , Gg^Efm      , Gg          , Gg^Efm      , Hh^Fms      , Hh^Fdw      , Mm          , Hh          , Gg^Efm      , Gg^Efm      , Gg^Efm      , Gg^Efm      , Mm          , Mm          , Hh^Fmw      , Mm          , Hh^Fp       , Mm          , Hh          , Mm          , Mm          , Mm^Xm       , Mm^Xm       , Ms          , Mm          , Mm          
Gs^Fp       , Gs^Fp       , Gs^Fp       , Gs^Fms      , Gs^Fp       , Gs^Fds      , Gs^Fds      , Gs^Fds      , Gs^Fp       , Gg^Efm      , Gs^Fp       , Gs^Fp       , Gs^Fp       , Gg^Efm      , Gg          , Gg          , Hh          , Gg          , Gg          , Gg          , Gg          , Gg^Efm      , Gg          , Ww          , Mm          , Hh          , Hh^Fms      , Hh          , Hh          , Hh          , Mm          , Hh^Fp       , Hh^Fp       , Hh^Fmw      , Hh^Fmw      , Hh^Fp       , Mm^Xm       , Mm^Xm       , Mm^Xm       , Mm^Xm       , Ms          , Ms          , Mm          , Khr         
Gs^Fms      , Gs^Fp       , Gg^Fet      , Gs^Fms      , Gs^Fp       , Gg^Fet      , Gs^Fms      , Gs^Fp       , Hh^Fp       , Hh^Fp       , Hh^Fp       , Hh^Fms      , Chr         , Hh^Fmw      , Mm          , Gg          , Hh          , Hh          , Hh^Fmw      , Gg          , Gg          , Gg^Efm      , Gg^Efm      , Mm          , Rp          , Rp          , Mm          , Hh^Fms      , Mm          , Mm          , Mm          , Hh          , Mm          , Hh          , Mm^Xm       , Mm^Xm       , Ms          , Ms          , Ms          , Ms          , Ms          , Ms          , Mm          , Chr         
Gs^Fms      , Gs^Fp       , Gs^Fds      , Gg^Fet      , Gs^Fp       , Gs^Fp       , Ce          , Ce          , Ke          , Hh^Fp       , Mm^Xm       , Mm          , Mm^Xm       , Ms          , Mm          , Mm          , Mm          , Mm          , Mm          , Hh          , Hh          , Gg          , Gg          , Hh^Fms      , Hh^Fms      , Mm          , Mm          , Mm          , Mm          , Mm          , Mm^Xm       , Mm^Xm       , Mm^Xm       , Mm^Xm       , Ms          , Ha          , Ha          , Khr         , Chr         , Mm          , Mm          , Mm          , 1 Hh        , Chr         
Gs^Fp       , Gs^Fms      , Gs^Fms      , Gs^Fp       , Gs^Fp       , Gs^Fp       , Hh^Fp       , Ce          , Mm          , Mm          , Mm^Xm       , Mm^Xm       , Mm          , Mm^Xm       , Mm^Xm       , Mm          , Mm          , Mm          , Mm          , Mm          , Mm          , Mm          , Hh^Fms      , Hh^Fms      , Mm          , Mm          , Mm^Xm       , Mm^Xm       , Mm^Xm       , Mm^Xm       , Ms          , Ms          , Ms          , Ms          , Ha          , Ww          , Mm          , Chr         , Mm          , Chr         , Hh          , Rp          , Mm          , Rp          
Gg^Fet      , Gg^Fet      , Gs^Fp       , Gs^Fms      , Gs^Fp       , Gs^Fp       , Hh^Fp       , Hh^Fp       , Mm          , Mm^Xm       , Mm          , Mm          , Gg^Efm      , Hh^Fp       , Mm          , Mm^Xm       , Mm^Xm       , Mm          , Hh          , Mm^Vhh      , Mm          , Hh^Fms      , Mm          , Mm          , Mm^Xm       , Mm          , Mm^Xm       , Mm          , Mm          , Ha          , Hh^Fmf      , Ms          , Ha          , Ms          , Ha          , Wo          , Gg          , Gg          , Hh          , Rp          , Hh          , Mm          , Mm          , Mm          
Gs^Fms      , Gs^Fp       , Gs^Fms      , Gs^Fms      , Hh^Fp       , Gs^Fp       , Hh^Fp       , Mm          , Mm^Xm       , Mm^Xm       , Mm          , Gg^Efm      , Gs^Fp       , Mm^Xm       , Mm^Xm       , Hh^Fp       , Hh          , Mm^Xm       , Mm^Xm       , Mm^Xm       , Mm^Xm       , Mm          , Mm^Xm       , Mm^Xm       , Mm^Xm       , Mm^Xm       , Hh          , Hh          , Gg^Efm      , Hh          , Gg          , Hh          , Hh          , Hh          , Wo          , Wo          , Gg^Efm      , Rp          , Hh^Vhh      , Hh          , Mm          , Mm          , Mm          , Mm          
Gs^Fp       , Gs^Fms      , Gs^Fp       , Gg^Ve       , Gs^Fp       , Hh^Fp       , Hh^Fp       , Mm^Xm       , Mm          , Mm          , Gg          , Hh          , Gs^Fp       , Mm          , Mm^Xm       , Gg^Efm      , Mm          , Gg^Efm      , Hh          , Hh          , Ms          , Mm^Xm       , Mm^Xm       , Mm          , Gg^Efm      , Hh          , Gg          , Gg          , Wo          , Gg^Efm      , Wwf         , Hh          , Wo          , Wo          , Hh^Fms      , Hh          , Rp          , Hh          , Mm          , Mm          , Hh^Fds      , Mm          , Mm^Xm       , Mm          
Gg          , Gs^Fp       , Hh^Fms      , Gs^Fds      , Gs^Fds      , Hh^Fp       , Mm^Xm       , Mm^Xm       , Mm          , Gs^Fp       , Gg          , Gg          , Mm          , Mm^Xm       , Mm          , Mm          , Gg^Efm      , Gg^Efm      , Gg^Efm      , Hh          , Mm          , Ms          , Hh^Vhh      , Hh          , Gg^Efm      , Gg          , Wo          , Wo          , Gg          , Wo          , Gg          , Wo          , Gg^Efm      , Gg^Efm      , Hh^Fms      , Gg^Efm      , Rp          , Hh          , Mm          , Hh^Fds      , Hh^Fds      , Mm          , Mm^Xm       , Ms          
Gg          , Gs^Fp       , Gs^Fp       , Gs^Fp       , Gs^Fds      , Hh^Fp       , Mm^Xm       , Mm          , Gg          , Gg          , Mm          , Mm          , Mm^Xm       , Mm^Xm       , Mm          , Ms          , Hh          , Hh^Fmf      , Hh^Fms      , Gg^Efm      , Hh^Fmf      , Ha^Fma      , Hh          , Hh^Fms      , Gg^Efm      , Wo          , Ss          , Ss          , Gg          , Gg          , Hh          , Gg^Efm      , Hh          , Gg^Efm      , Hh          , Hh^Fms      , Hh          , Hh          , Mm          , Hh^Fdw      , Mm          , Mm          , Mm^Xm       , Mm          
Gs          , Gg          , Gg          , Gs^Fp       , Gs^Fp       , Hh^Fp       , Mm^Xm       , Mm          , Gg          , Gg          , Mm          , Mm^Vc       , Mm^Xm       , Mm          , Hh          , Hh          , Gg^Efm      , Gg^Efm      , Mm          , Gg^Efm      , Gg^Efm      , Gg^Efm      , Hh          , Hh^Fms      , Gg^Efm      , Wo          , Ww          , Gg^Efm      , Gg          , Gg^Efm      , Gg^Efm      , Hh^Fp       , Hh^Fp       , Hh          , Rp          , Hh^Fms      , Hh          , Mm          , Ha          , Ha          , Ms          , Ms          , Mm^Xm       , Mm          
Gg          , Gg          , Hh^Fp       , Hh^Fmf      , Ha^Fma      , Mm^Xm       , Mm          , Mm          , Gs^Fp       , Mm          , Mm          , Mm^Xm       , Mm          , Hh          , Hh          , Hh^Fms      , Gg^Efm      , Hh^Vhh      , Gg          , Gg          , Gg          , Hh          , Gg          , Hh          , Gg          , Gg          , Wwf         , Gg^Efm      , Gg          , Hh          , Hh          , Hh          , Rp          , Rp          , Hh          , Hh          , Hh          , Ha^Vhha     , Mm          , Mm          , Ms          , Mm^Xm       , Mm          , Ms          
Gs^Fp       , Gg          , Hh^Fp       , Ms          , Mm^Xm       , Mm^Xm       , Mm          , Gg          , Mm          , Mm          , Mm^Xm       , Mm^Xm       , Mm          , Hh          , Hh          , Hh          , Ww          , Wwf         , Wwf         , Ww          , Wo          , Ww          , Wwf         , Wo          , Ww          , Gg          , Wo          , Wo          , Gg          , Hh          , Hh          , Hh          , Hh          , Hh          , Hh^Fp       , Hh          , Gg^Efm      , Gg^Efm      , Mm          , Mm          , Mm          , Mm^Xm       , Mm          , Mm          
Gg          , Hh^Fp       , Mm^Xm       , Mm^Xm       , Mm          , Mm          , Hh^Fms      , Gg          , Mm          , Mm^Xm       , Mm          , Mm          , Hh          , Hh          , Wwf         , Ww          , Gg          , Gg^Efm      , Gg^Efm      , Re          , Gg^Efm      , Hh          , Hh          , Gg          , Gg^Efm      , Wo          , Gg          , Wo          , Wo          , Gg          , Hh          , Rp          , Hh          , Hh^Fp       , Ha^Fma      , Hh^Fdw      , Mm          , Mm          , Mm          , Mm^Xm       , Mm^Xm       , Mm^Xm       , Mm          , Mm          
Ce          , Hh^Fp       , Mm^Xm       , Mm          , Gs^Fp       , Gs^Fp       , Gg^Efm      , Mm          , Mm          , Mm^Xm       , Mm^Xm       , Mm          , Mm          , Hh          , Ww          , Gg          , Gg          , Gg^Efm      , Hh^Fdw      , Gg          , Ce          , Ce          , Hh^Fms      , Hh          , Ww          , Wo          , Gg^Vh       , Gg^Efm      , Gg          , Wo          , Ww          , Rp          , Hh          , Ha^Fma      , Hh          , Ha          , Ms          , Mm          , Mm^Xm       , Mm^Xm       , Mm          , Mm          , Hh          , Hh          
Ke          , Gg          , Mm^Xm       , Mm          , Mm          , Mm          , Gg^Efm      , Mm          , Mm          , Mm          , Mm          , Mm^Xm       , Mm^Vhh      , Gg          , Wwf         , Gg^Efm      , Mm          , Mm          , Mm          , Mm          , Mm          , Ke          , Mm          , Mm          , Hh          , Hh          , Re          , Gg          , Wo          , Wo          , Gg          , Re          , Hh          , Hh          , Mm          , Mm          , Mm          , Ms          , Mm^Xm       , Mm          , Mm          , Hh^Fp       , Hh^Fp       , Hh          
Hh          , Mm          , Mm          , Mm^Xm       , Mm^Xm       , Mm          , Hh          , Gg^Efm      , Mm          , Mm          , Mm^Xm       , Mm^Xm       , Mm          , Gg          , Wo          , Gg          , Mm^Xm       , Mm          , Mm^Xm       , Mm^Xm       , Mm          , Mm          , Hh          , Hh          , Re          , Re          , Gg^Efm      , Wwf         , Ww          , Re          , Hh          , Hh          , Hh          , Hh          , Mm          , Mm          , Mm          , Mm          , Mm^Xm       , Mm          , Mm          , Hh^Vhh      , Hh          , Hh^Fp       
Hh          , Hh^Fp       , Mm          , Mm          , Mm^Xm       , Mm          , Hh          , Gg^Efm      , Ms          , Mm^Xm       , Mm^Xm       , Ha          , Ha          , Ww          , Mm          , Mm^Xm       , Mm          , Mm^Xm       , Hh^Vhh      , Mm          , Hh          , Hh          , Re          , Re          , Gg          , Gg^Efm      , Wo          , Ww          , Gg^Efm      , Gg^Efm      , Hh          , Hh          , Mm          , Mm          , Mm          , Ms          , Mm          , Gg^Efm      , Mm^Xm       , Mm^Xm       , Mm          , Hh          , Gg^Efm      , Hh^Fp       
Hh          , Hh^Fdw      , Mm          , Mm          , Mm^Xm       , Mm^Xm       , Hh          , Gg^Efm      , Mm          , Ms          , Mm          , Mm^Xm       , Mm^Xm       , Ms          , Mm^Xm       , Mm^Xm       , Mm          , Mm          , Hh          , Hh^Fmf      , Hh^Fmf      , Hh          , Gg^Efm      , Hh          , Gg^Efm      , Wo          , Gg^Efm      , Gg^Efm      , Hh          , Hh          , Ha          , Mm          , Mm          , Mm          , Mm          , Mm          , Gg^Efm      , Mm          , Mm^Xm       , Mm^Xm       , Mm          , Hh          , Hh          , Gg^Efm      
Mm          , Gg          , Mm^Xm       , Mm^Xm       , Hh^Fp       , Mm          , Gg^Efm      , Gg^Efm      , Mm          , Mm          , Mm^Xm       , Mm^Xm       , Ms          , Mm^Xm       , Mm          , Hh          , Gg^Efm      , Hh          , Hh          , Hh^Fmf      , Hh          , Hh          , Re          , Hh          , Gg          , Wo          , Gg^Efm      , Hh          , Hh          , Ha          , Mm          , Ms          , Ms          , Mm          , Mm          , Mm          , Mm^Xm       , Mm^Xm       , Mm          , Mm          , Hh          , Hh          , Mm          , Hh          
Ha^Vhha     , Mm^Xm       , Mm          , Mm          , Mm^Vc       , Mm          , Gg^Efm      , Mm          , Mm          , Mm^Xm       , Mm^Xm       , Ms          , Mm          , Mm          , Mm          , Hh          , Gg^Efm      , Gg^Efm      , Gg^Fet      , Hh          , Gg^Efm      , Hh          , Re          , Gg^Efm      , Ww          , Wo          , Gg^Efm      , Hh          , Hh          , Mm          , Mm          , Mm          , Ms          , Ms          , Mm^Xm       , Mm^Xm       , Ms          , Mm^Xm       , Mm          , Mm          , Hh          , Hh          , Hh^Fmf      , Hh          
Mm          , Mm^Xm       , Mm^Xm       , Mm          , Hh          , Gg^Efm      , Hh          , Mm          , Mm          , Mm^Xm       , Mm          , Hh          , Hh          , Hh^Fdw      , Gg^Efm      , Gg^Efm      , Hh^Fdw      , Hh          , Hh          , Hh          , Hh          , Re          , Gg          , Gg          , Wo          , Wo          , Gg          , Gg          , Hh          , Mm          , Mm          , Mm          , Ms          , Mm^Xm       , Ms          , Ms          , Ms          , Mm^Xm       , Ms          , Mm          , Hh^Vhh      , Hh          , Hh          , Hh          
Mm          , Mm          , Mm^Xm       , Mm          , Hh          , Gg^Efm      , Hh          , Mm          , Mm          , Mm^Xm       , Mm^Xm       , Hh          , Mm          , Hh^Fdw      , Mm          , Mm          , Mm          , Hh          , Hh^Fdw      , Hh^Vhh      , Hh          , Gg          , Gg^Efm      , Wo          , Gg^Efm      , Gg^Efm      , Hh          , Hh          , Hh          , Mm          , Mm          , Mm          , Mm^Xm       , Mm^Xm       , Mm          , Mm          , Mm          , Mm^Xm       , Mm^Xm       , Ms          , Mm          , Hh          , Hh          , Hh          
Mm          , Mm^Xm       , Mm          , Hh          , Hh          , Gg^Efm      , Hh          , Hh^Fms      , Hh^Fms      , Hh^Fmf      , Mm^Xm       , Mm          , Mm^Xm       , Mm          , Mm          , Ha          , Wo          , Hh          , Hh          , Hh          , Re          , Gg          , Wo          , Wo          , Gg^Efm      , Gg          , Hh          , Hh          , Chr         , Mm          , Mm          , Ms          , Mm^Xm       , Mm^Xm       , Mm          , Mm          , Mm          , Mm          , Mm^Xm       , Mm^Xm       , Mm          , Hh          , Hh          , Hh^Fp       
Mm          , Mm^Xm       , Mm          , Gs^Fp       , Hh^Fmw      , Gg^Efm      , Hh          , Hh          , Ms          , Mm^Xm       , Mm          , Mm          , Mm          , Mm^Xm       , Mm^Xm       , Mm^Xm       , Hh          , Wo          , Hh          , Re          , Gg^Efm      , Gg^Efm      , Wo          , Gg          , Hh          , Gg          , Hh          , Hh          , Hh^Vhh      , Mm          , Ms          , Ms          , Mm^Xm       , Mm          , Gg          , Hh          , Ww          , Mm          , Gg          , Mm^Xm       , Mm^Xm       , Gg^Efm      , Hh          , Hh          
Hh          , Mm^Xm       , Mm          , Gg          , Hh^Fmw      , Hh^Vc       , Ms          , Mm          , Ms          , Mm^Xm       , Mm^Xm       , Ms          , Ms          , Mm          , Mm          , Hh          , Hh^Fds      , Wo          , Wo          , Gs^Fp       , Gg^Efm      , Wo          , Gg^Efm      , Gg^Efm      , Gg          , Gg          , Hh          , Hh          , Ha          , Mm          , Ms          , Mm^Xm       , Mm          , Mm          , Gg^Efm      , Hh          , Ww          , Gg          , Gg^Efm      , Mm          , Mm          , Mm          , Hh          , Hh          
Hh          , Mm^Xm       , Mm          , Gg          , Gg          , Mm          , Ms          , Ms          , Mm^Xm       , Mm^Xm       , Mm          , Ms          , Mm          , Mm          , Mm          , Hh^Fds      , Hh          , Hh          , Re          , Wo          , Wo          , Wo          , Gg^Efm      , Gg          , Hh          , Hh          , Hh          , Hh          , Ha          , Ms          , Mm^Xm       , Mm^Xm       , Hh          , Hh          , Gg^Efm      , Gg^Efm      , Ww          , Gg          , Hh          , Mm          , Mm          , Mm          , Hh          , Hh          
Mm^Xm       , Mm^Xm       , Mm          , Gg^Efm      , Mm          , Mm          , Mm^Xm       , Mm^Xm       , Mm^Xm       , Mm          , Mm          , Mm          , Mm          , Mm          , Mm          , Hh^Fms      , Gg          , Hh          , Gg^Efm      , Gg          , Wo          , Gg          , Hh          , Hh          , Hh          , Hh          , Hh          , Hh          , Gg^Efm      , Mm          , Mm^Xm       , Mm          , Hh          , Hh          , Hh          , Gg          , Ww          , Gg          , Hh          , Mm          , Mm          , Mm          , Hh          , Gg          
Mm^Xm       , Mm          , Mm          , Hh          , Ms          , Mm^Xm       , Mm^Xm       , Mm          , Hh          , Mm          , Mm          , Mm          , Mm          , Mm          , Hh^Fds      , Hh^Fms      , Gg          , Gg^Efm      , Gg          , Wo          , Gg^Efm      , Gg          , Hh          , Hh          , Ce          , Hh          , Mm          , Gg^Efm      , Mm          , Mm^Xm       , Mm          , Mm          , Hh          , Hh          , Hh          , Hh          , Hh          , Wwf         , Hh          , Mm          , Mm          , Mm          , Hh          , Hh          
Mm          , Mm^Xm       , Mm^Xm       , Mm          , Mm          , Mm          , Hh^Fp       , Mm          , Hh          , Gg^Efm      , Hh^Fds      , Mm          , Hh^Vhh      , Hh^Fds      , Gg          , Gg          , Ss          , Gg^Efm      , Gg          , Ww          , Gg          , Gg^Efm      , Ce          , Ce          , Ke          , Mm          , Mm          , Mm          , Mm^Xm       , Mm^Xm       , Mm          , Mm          , Hh          , Gg          , Hh          , Hh          , Hh          , Wwf         , Hh          , Hh          , Gg          , Hh          , Hh          , Gs^Fp       
Mm          , Mm^Xm       , Mm          , Mm          , Mm          , Hh          , Gg^Efm      , Hh          , Hh^Fdw      , Hh^Fms      , Hh^Fdw      , Hh^Fds      , Gg^Efm      , Gg^Efm      , Gg          , Gg          , Ss          , Ss          , Ww          , Ww          , Gg          , Gg^Efm      , Gg          , Ce          , Gg^Efm      , Mm          , Mm          , Mm^Xm       , Mm          , Mm          , Mm          , Mm          , Hh          , Hh          , Hh          , Hh          , Gg          , Ww          , Gg          , Hh          , Hh          , Hh          , Gg          , Gg          
Mm^Xm       , Mm^Xm       , Mm          , Mm          , Mm          , Hh          , Gg^Efm      , Gg^Efm      , Gg          , Gg^Efm      , Gg          , Gg          , Gg          , Ss          , Ds          , Ds          , Ww          , Ww          , Wwf         , Ww          , Ww          , Ds          , Ds          , Gg          , Gg          , Gg^Efm      , Gg          , Hh^Vhh      , Hh          , Mm          , Ce          , Ke          , Gg          , Gg          , Gg^Efm      , Gg          , Gg^Efm      , Ww          , Gg          , Gg          , Hh          , Hh          , Hh          , Gg          
Mm          , Mm^Xm       , Mm^Xm       , Mm          , Hh^Fms      , Hh          , Gg          , Gg^Efm      , Ds          , Gg          , Ds          , Gg          , Ds          , Ds          , Ww          , Ww          , Ww          , Ww          , Wwr         , Ww          , Ww          , Ww          , Ww          , Ww          , Ww          , Gg          , Ww          , Gg          , Ww          , Gg          , Gg          , Ce          , Gg          , Gg^Efm      , Gg          , Gg^Efm      , Gg^Efm      , Wwf         , Ww          , Gg          , Hh          , Hh          , Gg          , Hh          
Mm          , Mm          , Mm          , Mm          , Ke          , Gg^Efm      , Gg          , Gg          , Ww          , Ds          , Ww          , Ww          , Wo          , Ww          , Wo          , Wo          , Ww          , Ww          , Ww          , Ww          , Wo          , Wo          , Wo          , Wo          , Wo          , Ww          , Ww          , Ww          , Ww          , Ww          , Ww          , Gg          , Gg          , Gg^Efm      , Gg          , Ss          , Gg^Efm      , Gg          , Ww          , Gg          , Gg          , Gg          , Gg          , Gg          
Hh          , Mm          , Mm          , Mm          , Ce          , Ce          , Gg          , Ww          , Wo          , Ww          , Wo          , Wo          , Wo          , Wo          , Ww          , Ww          , Wo          , Ww          , Wo          , Ww          , Wo          , Wo          , Wo          , Wo          , Wo          , Wo          , Wo          , Wo          , Wo          , Ww          , Ww          , Ww          , Ww          , Ds          , Ds          , Gg          , Gg          , Gg^Efm      , Ww          , Gg          , Gg          , Gg          , Gs^Fp       , Gg          
Hh          , Hh^Fds      , Mm          , Mm          , Gg          , Gg          , Ww          , Ww          , Ww          , Wo          , Wo          , Wo          , Wo          , Ww          , Wo          , Wo          , Wo          , Gg^Efm      , Gg^Efm      , Wo          , Wo          , Wo          , Wo          , Wo          , Wo          , Wo          , Wo          , Wo          , Wo          , Wo          , Wo          , Ww          , Wwf         , Ww          , Ds          , Gg          , Ss          , Gg          , Ss          , Ww          , Gg          , Gg          , Gg          , Gs^Fms      
Gg          , Hh^Fds      , Hh          , Mm          , Gg          , Gg          , Ww          , Wo          , Wo          , Wo          , Wo          , Wo          , Wo          , Ww          , Ww          , Wo          , Wo          , Wo          , Gg^Efm      , Ds          , Wo          , Wo          , Wo          , Wo          , Wo          , Wo          , Wo          , Wo          , Wo          , Wo          , Ww          , Ww          , Wo          , Ww          , Ww          , Ds          , Ss          , Ss          , Ss          , Ww          , Ss          , Gg          , Gg          , Gs^Fds      
Gg          , Gg          , Gg          , Hh          , Ds          , Ds          , Wo          , Wo          , Wo          , Wo          , Wo          , Wo          , Wo          , Wo          , Ww          , Ww          , Ds          , Gs          , Mm          , Hh^Vc       , Hh          , Wo          , Wo          , Wo          , Wo          , Wo          , Ww          , Wo          , Wo          , Wo          , Wo          , Wo          , Wo          , Wo          , Wo          , Ww          , Ww          , Ss          , Ss          , Ww          , Ss          , Ss          , Gs^Fp       , Gs^Fp       
Ds          , Ds          , Ww          , Ww          , Wo          , Ww          , Ww          , Wo          , Wo          , Wo          , Wo          , Wo          , Wo          , Wo          , Ww          , Ww          , Gs          , Gs          , Ww          , Hh          , Wo          , Wo          , Wwr         , Wwr         , Ww          , Wwr         , Wo          , Ww          , Ww          , Wo          , Wo          , Wo          , Wo          , Wo          , Ww          , Wo          , Ww          , Ds          , Ww          , Wwf         , Ss          , Ss^Vm       , Gg          , Gg          
Wwr         , Ww          , Ww          , Ww          , Wo          , Wo          , Wo          , Ww          , Wo          , Wo          , Wo          , Wo          , Wo          , Wo          , Wo          , Ww          , Ww          , Gs          , Ww          , Ww          , Ww          , Wwr         , Wo          , Wo          , Wo          , Wo          , Wo          , Ww          , Wo          , Wo          , Wo          , Wo          , Ww          , Ww          , Wwr         , Wwr         , Ww          , Wwf         , Ds          , Ss          , Ss          , Ss          , Ss          , Ss          
