border_size=1
usage=map

Mm, Mm, Mm, Hh^Fdw, Hh^Fdw, Gg, Gg, Gg, Hh, Hh^Fdw, Hh^Fp, Gg, Gg, Gg, Gg, Gg, Gg, Gg, Gs^Fp, Gs^Fp, Gs^Fms, Hh^Fms, Hh^Fms, Gs^Fp, Gs^Fms, Gs^Fp, Gs^Fms, Gs^Fms, Hh^Fp
Ms, Ms, Mm, Hh^Fdw, Gg, Hh, Hh, Gg, Hh, Hh, Hh^Fp, Gg, Gg, Gg, Gg, Gg, Gg, Gg, Gg, Gs^Fp, Gs^Fp, Gs^Fp, Gs^Fp, Gs^Fms, Gs^Fp, Gs^Fms, Gs^Fp, Gg^Ve, Gs^Fp
Ms, Mm, Mm, Hh, Hh^Fdw, Hh, Gg, Hh, Mm, Mm, Mm, Hh^Fp, Gg, Gg, Gg, Gg, Gg, Gg, Gs, Gg, Gg, Gs^Fp, Gg, Gs^Fp, Gg, Gs^Fp, Hh^Fms, Gs^Fds, Gs^Fds
Mm, Mm, 4 Ke, Mm, Hh^Fdw, Gg, Gg, Hh^Vhh, Mm, Mm, Mm, Gg, Gg, Gg, Gg, Gg, Gs, Gg, Gg, Gg, Gg, Gg, Gg, Gg, Gg, Gs^Fp, Gs^Fp, Gs^Fp, Gs^Fds
Mm, Mm, Ce, Ce, Ce, Gg, Hh, Hh^Fdw, Hh^Fdw, Mm, Gg, Gg, Gs, Gg, Gg, Gg, Gs, Gg, Gs, Gs, Gs^Fp, Gg, Gg, Gg, Gs, Gg, Gg, Gs^Fp, Gs^Fp
Gg, Mm, Hh, Ce, Hh, Hh, Mm, Hh, Hh, Hh, Gs, Gs, Gs, Gg, Hh^Fp, Gg, Gs^Fp, Gs, Gg, Gg, Hh^Fp, Gs^Fp, Gs^Fp, Gg, Gg, Gg, Hh^Fp, Hh^Fmf, Ha^Fma
Hh, Hh^Vhh, Hh, Hh, Gg, Mm, Hh^Fdw, Hh, Hh, Gg, Gs, Gs, Gs, Gg, Gs^Fp, Hh^Fp, Gg, Gg, Gg, Gg, Gs^Fp, Gs, Gg, Gg, Gs^Fp, Gg, Hh^Fp, Ms, Mm^Xm
Gg, Hh, Hh^Fdw, Mm, Mm, Mm, Mm, Hh, Gs, Gs, Gg, Gg^Efm, Gs, Gg, Gg, Gg, Gg, Gg, Gg, Gs^Fp, Hh^Fp, Gg, Gs^Fp, Gs^Fp, Gg, Hh^Fp, Mm^Xm, Mm^Xm, Mm
Hh, Hh^Fdw, Hh^Fdw, Hh^Fdw, Hh, Hh, Hh, Hh, Gg^Efm, Gg, Gs, Gg^Efm, Gg^Efm, Gg, Gg, Gs^Fp, Hh^Fp, Gg^Vc, Hh, Hh^Fp, Hh^Fmw, Gs^Fp, Gs, Gg, Ce, Hh^Fp, Mm^Xm, Mm, Gs^Fp
Hh, Mm, Hh, Mm, Hh, Hh, Gg, Gg^Efm, Gs, Gg^Efm, Hh^Fp, Gs^Fp, Gg^Efm, Gg, Gg, Hh, Hh, Hh, Ms, Mm, Hh, Gs, Gg, Ce, 5 Ke, Gg, Mm^Xm, Mm, Mm
Hh, Hh^Fdw, Hh^Fdw, Hh, Gg, Gg, Gg, Gg^Efm, Gg, Gs, Gg, Gg, Gg, Gg, Gg^Efm, Gg, Hh^Fp, Mm, Mm^Xm, Mm, Hh^Vhh, Gg, Gs, Gg^Efm, Hh, Mm, Mm, Mm^Xm, Mm^Xm
Gg, Hh, Hh, Hh^Fp, Hh^Fms, Gg, Hh^Fms, Hh, Hh, Hh, Gg^Efm, Gg, Gg, Hh, Hh, Hh, Mm, Mm^Xm, Mm, Gg, Gs, Gg, Gs, Gg^Efm, Hh, Hh^Fp, Mm, Mm, Mm^Xm
Gg, Gg, Gg, Gg, Hh, Hh^Fms, Mm, Hh, Gg, Gs, Gg, Gs, Gg, Gg, Gg^Efm, Mm, Mm^Xm, Mm^Xm, Hh^Fms, Hh, Hh, Gg, Gg^Efm, Gg^Efm, Hh, Hh^Fdw, Mm, Mm, Mm^Xm
Gg, Gg, Hh, Hh, Mm, Mm, Gg^Efm, Gg^Efm, Gg, Gg^Efm, Gg^Efm, Gs, Gg, Hh, Mm, Mm, Mm^Xm, Mm, Hh^Fdw, Hh, Gg, Gg^Efm, Gg^Efm, Gg^Efm, Mm, Gg, Mm^Xm, Mm^Xm, Hh^Fp
Hh, Hh, Hh^Fms, Mm, Hh, Mm, Gg, Gg, Gg, Gg, Gg^Efm, Gg, Gg, Hh, Mm, Ms, Ms, Mm^Xm, Mm, Gg, Gs, Gg^Efm, Gg^Efm, Hh, Ha^Vhha, Mm^Xm, Mm, Mm, Mm^Vc
Gg, Gg, Gg, Gg, Ds, Hh, Gg, Gs^Vht, Gg, Ww, Ss, Gg, Gg, Mm, Ww, Ms, Mm, Mm^Xm, Mm, Hh, Gs, Gg, Gg^Efm, Hh, Mm, Mm^Xm, Mm^Xm, Mm, Hh
Gg, Ss, Ss, Gg, Ss, Gg^Efm, Gg, Gg, Gg, Gg, Gg, Gg, Gg, Gg, Ww, Mm, Mm, Mm^Xm, Mm^Xm, Mm, Hh, Gg, Gg^Efm, Gg^Efm, Mm, Mm, Mm^Xm, Mm, Hh
Gg, Gg, Gg, Gg, Gg, Gg, Gg, Gg, Gg, Gg, Gg, Gg, Gg, Gg, Wwf, Hh^Fmw, Gg^Efm, Mm, Mm, Mm^Xm, Mm, Gg, Gg^Efm, Gg, Mm, Mm^Xm, Mm, Hh, Hh
Ss, Gg, Ss, Ss, Ss, Gg, Gg, Gg, Ss, Gg, Ss, Ss, Wo, Ww, Gg^Efm, Gg, Gg^Efm, Hh^Fmw, Mm, Mm^Xm, Mm^Xm, Mm, Mm, Gg, Mm, Mm^Xm, Mm, Gs^Fp, Hh^Fmw
Ss, Gg, Gg^Efm, Gg^Efm, Ss, Gg, Ss, Gg, Ss, Ds, Ww, Wo, Ss, Ss, Ww, Gg^Efm, Gg, Hh, Gg^Efm, Mm, Ha, Mm^Xm, Mm, Hh, Hh, Mm^Xm, Mm, Gg, Hh^Fmw
Ss, Gg, Ss, Ss^Vhs, Ss, Gg^Efm, Gg, Ss, Ss, Ww, Ww, Ss, Ss, Ss, Ss, Gg^Efm, Gg, Gg, Wwf, Ww, Hh, Mm^Xm, Mm, Hh, Hh, Mm^Xm, Mm, Gg, Gg
Ss, Gg, Gg, Ss, Ss, Gg, Gg, Ss, Ss, Ww, Ww, Ss, Ss, Ss, Ss, Gg, Ww, Ww, Gs^Fp, Gs^Fp, Chr, Mm, Hh^Fp, Mm, Mm^Xm, Mm^Xm, Mm, Gg^Efm, Mm
Ss, Ss, Gg, Gg, Ss, Ss, Gg^Efm, Ss, Ss, Ww, Ss, Ss, Ss, Ss, Ww, Ww, Ss, Ww, Gg, Gs^Fp, Chr, Khr, Mm^Vhh, Mm, Mm^Xm, Mm, Mm, Hh, Ms
Ss, Ss, Ss, Ss, Gg^Efm, Ss, Ss, Ss, Wo, Ww, Gg, Gg, Gg, Ss, Ww, Ww, Ss, Gg, Gg, Gg^Efm, Hh, Chr, Hh^Fmw, Mm, Mm, Mm^Xm, Mm^Xm, Mm, Mm
Ss, Gg, Ss, Ss, 3 Khs, Ss, Ds, Wo, Ww, Ss, Ss^Vhs, Gg, Gg, Ds, Wo, Ss, Ss, Gg, Gg, Hh^Fp, Hh^Fms, Gg^Efm, Hh^Fmw, Mm, Mm, Mm^Xm, Mm, Mm, Mm
Ss, Ss, Ss, Ss, Chs, Ss, Wo, Wo, Ss, Ss, Ss, Ss, Ss, Ds, Ww, Ss, Gg, Gg, Gg^Efm, Gg, Gg, Gg^Efm, Mm^Vhh, Hh, Mm^Xm, Mm^Xm, Mm, Mm, Mm
Gg, Ss, Ss, Ss, Chs, Chs, Ww, Ww, Re, Re, Rd, Re, Re, Re, Ww, Re, Gg^Efm, Ss, Ss, Gg^Efm, Gg^Efm, Hh, Hh, Hh, Mm, Mm^Xm, Mm^Xm, Mm, Hh^Fms
Ss, Ss, Gg, Gg, Gg, Ss, Re, Ww, Ss, Ss, Ss, Ss, Ss, Ss, Ww, Gg, Gg^Efm, Re, Re, Gg^Efm, Hh^Fms, Gg^Efm, Gg^Efm, Hh, Mm, Mm, Mm, Mm, Ke
Ss, Ss, Ss, Ss, Re, Re, Gg, Ww, Ww, Ss, Ss, Ds, Ds, Ss, Ww, Ww, Ds, Ds, Ss, Hh, Gg, Gg^Efm, Gg^Efm, Hh, Hh, Mm, Mm, Mm, Ce
Ss, Ss, Re, Re, Ss, Gg, Ds, Ds, Ww, Ss, Wo, Wo, Ww, Ww, Ww, Ww, Gg, Gg, Gg, Hh, Gg, Gg^Efm, Gg^Efm, Gg^Efm, Hh, Hh^Fds, Mm, Mm, Gg
Re, Re, Ss^Vhs, Ss, Ss, Ss, Ds, Ds, Ww, Ww, Ww, Ww, Ss, Ww, Ds, Ds, Ww, Ww, Gg, Gg, Gg, Gg, Wo, Gg^Efm, Gg, Hh^Fds, Hh, Mm, Gg
Ss, Ss, Ss, Ss, Gg, Gg, Ww, Ww, Ww, Ww, Ww, Ww, Ss, Gg^Efm, Ww, Ww, Wo, Ww, Ww, Gg, Ww, Ds, Gg^Efm, Gs^Vht, Gg, Gg, Gg, 1 Hh, Ds
Gg, Ss, Ss, Ds, Ww, Ww, Wo, Wo, Ww, Ds, Ww, Ss^Vm, Ww, Ww, Wo, Ww, Wo, Wo, Wo, Ww, Wo, Ww, Ww, Ds, Ds, Ds, Ww, Ww, Wo
Ww, Ss, Ww, Ww, Ww, Ww, Wo, Ww, Ww, Ww, Ww, Ww, Ww, Wo, Wo, Wo, Wo, Wo, Wo, Wo, Wo, Wo, Wo, Ww, Wwr, Ww, Ww, Ww, Wo
