border_size=1
usage=map

Mm, Mm, Mm, Hh^Fdw, Hh^Fdw, Gg, Gg, Gg, Hh, Hh^Fdw, Hh^Fp, Gg, Gg, Gg, Gg, Gg, Gg, Gg, Gs^Fp, Gs^Fp, Gs^Fms, Hh^Fms, Hh^Fms, Gs^Fp, Gs^Fms, Gs^Fp, Gs^Fms, Gs^Fms, Hh^Fp
Ms, Ms, Mm, Hh^Fdw, Gg, Hh, Hh, Gg, Hh, Hh, Hh^Fp, Gg, Gg, Gg, Gg, Gg, Gg, Gg, Gg, Gs^Fp, Gs^Fp, Gs^Fp, Gs^Fp, Gs^Fms, Gs^Fp, Gs^Fms, Gs^Fp, Gg^Ve, Gs^Fp
Ms, Mm, Mm, Hh, Hh^Fdw, Hh, Gg, Hh, Mm, Mm, Mm, Hh^Fp, Gg, Gg, Gg, Gg, Gg, Gg, Gs, Gg, Gg, Gs^Fp, Gg, Gs^Fp, Gg, Gs^Fp, Hh^Fms, Gs^Fds, Gs^Fds
Mm, Mm, 4 Ke, Mm, Hh^Fdw, Gg, Gg, Hh^Vhh, Mm, Mm, Mm, Gg, Gg, Gg, Gg, Gg, Gs, Gg, Gg, Gg, Gg, Gg, Gg, Gg, Gg, Gs^Fp, Gs^Fp, Gs^Fp, Gs^Fds
Mm, Mm, Ce, Ce, Ce, Gg, Hh, Hh^Fdw, Hh^Fdw, Mm, Gg, Gg, Gs, Gg, Gg, Gg, Gs, Gg, Gs, Gs, Gs^Fp, Gg, Gg, Gg, Gs, Gg, Gg, Gs^Fp, Gs^Fp
Mm, Mm, Hh, Ce, Hh, Hh, Mm, Hh, Hh, Hh, Gs, Gs, Gs, Gg, Hh^Fp, Gg, Gs^Fp, Gs, Gg, Gg, Hh^Fp, Gs^Fp, Gs^Fp, Gg, Gg, Gg, Hh^Fp, Hh^Fmf, Ha^Fma
Hh, Hh^Vhh, Hh, Hh, Gg, Mm, Hh^Fdw, Hh, Hh, Gg, Gs, Gs, Gs, Gg, Gs^Fp, Hh^Fp, Gg, Gg, Gg, Gg, Gs^Fp, Gs, Gg, Gg, Gs^Fp, Gg, Hh^Fp, Ms, Mm^Xm
Mm, Hh, Hh^Fdw, Mm, Mm, Mm, Mm, Hh, Gs, Gs, Gg, Gg^Efm, Gs, Gg, Gg, Gg, Gg, Gg, Gg, Gs^Fp, Hh^Fp, Gg, Gs^Fp, Gs^Fp, Gg, Hh^Fp, Mm^Xm, Mm^Xm, Mm
Hh, Hh^Fdw, Hh^Fdw, Hh^Fdw, Hh, Hh, Hh, Hh, Gg^Efm, Gg, Gs, Gg^Efm, Gg^Efm, Gg, Gg, Gs^Fp, Hh^Fp, Gg^Vc, Hh, Hh^Fp, Hh^Fmw, Gs^Fp, Gs, Gg, Ce, Hh^Fp, Mm^Xm, Mm, Gs^Fp
Hh, Mm, Hh, Mm, Hh, Hh, Gg, Gg^Efm, Gs, Gg^Efm, Hh^Fp, Gs^Fp, Gg^Efm, Gg, Gg, Hh, Hh, Hh, Ms, Mm, Hh, Gs, Gg, Ce, 5 Ke, Gg, Mm^Xm, Mm, Mm
Hh, Hh^Fp, Hh^Fms, Hh, Gg, Gg, Gg, Gg, Gg, Gs, Gg, Gg, Gg, Gg, Gg^Efm, Gg, Hh^Fp, Mm, Mm^Xm, Mm, Hh^Vhh, Gg, Gs, Gg, Hh, Mm, Mm, Mm^Xm, Mm^Xm
Gg, Hh, Hh, Hh^Fp, Hh^Fms, Gg, Gg, Hh, Hh, Hh, Gg^Efm, Gg, Gg, Hh, Hh, Hh, Mm, Mm^Xm, Mm, Gg, Gs, Gg, Gs, Gg, Hh, Hh^Fp, Mm, Mm, Mm^Xm
Mm, Mm, Mm, Gg, Hh, Hh^Fms, Hh^Vhh, Mm, Gg, Gs, Gg, Gs, Gg, Gg, Gg^Efm, Mm, Mm^Xm, Mm^Xm, Hh^Fms, Hh, Hh, Gg, Gg, Gg, Hh, Hh^Fdw, Mm, Mm, Mm^Xm
Hh^Vhh, Mm, Hh, Mm, Hh, Hh, Hh, Gg^Efm, Gg, Gg, Gg, Gs, Gg, Hh, Mm, Mm, Mm^Xm, Mm, Hh^Fdw, Hh, Gg, Gg^Efm, Gg, Gg^Efm, Mm, Gg, Mm^Xm, Mm^Xm, Hh^Fp
Hh, Hh, Hh^Fms, Mm, Hh, Mm, Gg, Gg, Gg, Gg, Gg^Efm, Gg, Hh, Hh, Mm, Ms, Ms, Mm^Xm, Mm, Gg, Gs, Gg, Gg, Hh, Hh^Vhh, Mm^Xm, Mm, Mm, Mm^Vc
Ss, Gg, Gg, Gg, Gg, Hh, Gg, Gg, Gg, Gg, Gg, Gg, Hh^Vhh, Mm, Ww, Ms, Mm, Mm^Xm, Mm, Hh, Gs, Gg, Gg, Hh, Mm, Mm^Xm, Mm^Xm, Mm, Hh
Ss, Ss, Ss, Hh, Ss, Gg^Efm, Gg, Gg, Gg, Gg, Gg, Hh, Ss, Gg, Wwf, Mm, Mm, Mm^Xm, Mm^Xm, Mm, Hh, Gg, Gg, Gg, Mm, Mm, Mm^Xm, Mm, Hh
Gg, Gg, Gg, Gg, Gg, Gg, Gg, Ss, Gg, Ss, Gg, Gg, Ss, Ss, Gg, Ss, Ss, Mm, Mm, Mm^Xm, Mm, Gg, Gg, Gg, Mm, Mm^Xm, Mm, Hh, Hh
Ss, Ss, Gg, Ss, Ss, Ss, Ss, Ss, Ss, Gg, Ss, Ss, Wo, Ww, Ww, Ss, Ss, Hh, Mm, Mm^Xm, Mm^Xm, Mm, Mm, Gg, Mm, Mm^Xm, Mm, Gs^Fp, Hh^Fmw
Ss, Gg, Gg^Efm, Gg^Efm, Ss, Ss, Gg, Gg, Ss, Ds, Ww, Wo, Ss, Ss, Ww, Ss, Ww, Hh, Ss, Hh, Hh, Mm^Xm, Mm, Hh, Hh, Mm^Xm, Mm, Gg, Hh^Fmw
Ss, Gg, Ss^Vhs, Ss, Ss, Gg^Efm, Gg, Ss^Vhs, Ss, Ww, Ww, Ss, Ss, Ww, Gg, Ss, Gg, Ss, Wwf, Ww, Hh, Mm^Xm, Mm, Hh, Hh, Mm^Xm, Mm, Gg, Gg
Ss, Ss, Gg, Ww, Ss, Gg, Gg, Gg, Gg, Ww, Ww, Gg, Ss, Ww, Ww, Ss, Ww, Ww, Gs^Fp, Gs^Fp, Chr, Mm, Hh^Fp, Mm, Mm^Xm, Mm^Xm, Mm, Gg^Efm, Mm
Ss, Ss, Gg, Gg, Ss, Ss, Ww, Ss, Ss, Ww, Gg, Ss, Ss, Ss, Ww, Ss^Vhs, Ss, Ww, Gg, Gs^Fp, Chr, Khr, Mm^Vhh, Mm, Mm^Xm, Mm, Mm, Hh, Ms
Gg, Ss, Gg, Ss, Gg^Efm, Gg, Ss, Ss, Wo, Ww, Gg, Ss, Gg, Ss, Ww, Ww, Ss, Gg, Rb, Gs, Hh, Chr, Hh^Fmw, Mm, Mm, Mm^Xm, Mm^Xm, Mm, Mm
Ss, Gg, Ss, Ss, 3 Chs, Gg, Ds, Wo, Ww, Ss, Ss^Vhs, Gg^Efm, Gg, Ds, Wo, Gg, Ss, Gg, Rb, Hh^Fp, Hh^Fms, Gg, Hh^Fmw, Mm, Mm, Mm^Xm, Mm, Mm, Mm
Ss, Ww, Gg, Ss, Chs, Gg, Wo, Wo, Ss, Ss, Ss, Ss, Ss, Gs, Ww, Ss, Rb, Rb, Gg, Gg, Gg, Gg^Efm, Mm^Vhh, Hh, Mm^Xm, Mm^Xm, Mm, Mm, Mm
Gg, Gg, Ss, Gg, Khs, Chs, Ww, Ww, Rb, Rb, Rb, Rb, Rb, Re, Ww, Rb, Gg^Efm, Ss, Ss, Gg, Gg^Efm, Hh, Hh, Hh, Mm, Mm^Xm, Mm^Xm, Mm, Hh^Fms
Ss, Ss, Gg, Gg^Efm, Gg, Ss^Vhs, Rb, Ww, Ss, Ss, Ss, Ss, Gg, Ss, Ww, Gg, Gg^Efm, Gg, Gg, Gg^Efm, Hh^Fms, Gg^Efm, Gg^Efm, Hh, Mm, Mm, Mm, Mm, Ke
Ss, Ss, Gg, Ss, Rb, Rb, Gg, Ww, Ww, Gg, Ss, Ds, Ds, Ss, Ww, Ww, Ds, Ds, Ss, Hh, Gg, Gg, Gg, Hh, Hh, Mm, Mm, Mm, Ce
Ss, Ss, Rb, Rb, Ss, Gg^Efm, Ds, Ds, Ww, Ss, Wo, Wo, Ww, Ww, Ww, Ww, Gg, Gg, Gg, Hh, Gg, Gg, Gg^Efm, Gg^Efm, Hh, Hh^Fds, Mm, Mm, Gg
Rb, Rb, Ss^Vhs, Gg, Ss, Ss, Ds, Ds, Ww, Ww, Ww, Ww, Ss, Ww, Ds, Ds, Ww, Ww, Gg, Gg, Gg, Gg, Wo, Gg^Efm, Gg, Hh^Fds, Hh, Mm, Gg
Gg, Ss, Ss, Ss, Gg, Gg, Ww, Ww, Ww, Ww, Ww, Ww, Ss, Gg^Efm, Ww, Ww, Wo, Ww, Ww, Gg, Ww, Ds, Gg^Efm, Gg^Vht, Gg, Gg, Gg, 1 Hh, Ds
Ww, Ss, Ss, Ds, Ww, Ww, Wo, Wo, Ww, Ds, Ww, Ss^Vm, Ww, Ww, Wo, Ww, Wo, Wo, Wo, Ww, Wo, Ww, Ww, Ds, Ds, Ds, Ww, Ww, Wo
Wo, Ss, Ww, Ww, Ww, Ww, Wo, Ww, Ww, Ww, Ww, Ww, Ww, Wo, Wo, Wo, Wo, Wo, Wo, Wo, Wo, Wo, Wo, Ww, Wwr, Ww, Ww, Ww, Wo
