border_size=1
usage=map

Gg, Gg, Gg, Gg, Gg, Gg, Gs^Fp, Gs^Fp, Gs^Fms, Hh^Fms, Hh^Fms, Gs^Fp, Gs^Fms, Gs^Fp, Gs^Fms, Gs^Fms, Hh^Fp, Gs^Fp, Hh^Fp, Mm, Mm^Xm, Mm^Xm, Mm, Gg^Efm, Gs^Fp, Mm^Xm, Mm^Xm
Gg, Gg, Gg, Gg, Gg, Gg, Gg, Gs^Fp, Gs^Fp, Gs^Fp, Gs^Fp, Gs^Fms, Gs^Fp, Gs^Fms, Gs^Fp, Gg^Ve, Gs^Fp, Hh^Fp, Hh^Fp, Mm^Xm, Mm, Mm, Gg, Hh, Gs^Fp, Mm, Mm^Xm
Gg, Gg, Gg, Gg, Gg, Gg, Gs, Gg, Gg, Gs^Fp, Gg, Gs^Fp, Gg, Gs^Fp, 1 Hh^Fms, Gs^Fds, Gs^Fds, Hh^Fp, Mm^Xm, Mm^Xm, Mm, Gs^Fp, Gg, Gg, Mm, Mm^Xm, Mm
Gg, Gg, Gg, Gg, Gs, Gg, Gg, Gg, Gg, Gg, Gg, Gg, Gg, Gs^Fp, 2 Gs^Fp, Gs^Fp, Gs^Fds, Hh^Fp, Mm^Xm, Mm, Gg, Gg, Mm, Mm, Mm^Xm, Mm^Xm, Mm
Gs, Gg, Gg, Gg, Gs, Gg, Gs, Gs, Gs^Fp, Gg, Gg, Gg, Gs, Gg, Gg, Gs^Fp, Gs^Fp, Hh^Fp, Mm^Xm, Mm, Gg, Gg, Mm, Mm^Vc, Mm^Xm, Mm, Hh
Gs, Gg, Hh^Fp, Gg, Gs^Fp, Gs, Gg, Gg, Hh^Fp, Gs^Fp, Gs^Fp, Gg, Gg, Gg, Hh^Fp, Hh^Fmf, Ha^Fma, Mm^Xm, Mm, Mm, Gs^Fp, Mm, Mm, Mm^Xm, Mm, Hh, Hh
Gs, Gg, Gs^Fp, Hh^Fp, Gg, Gg, Gg, Gg, Gs^Fp, Gs, Gg, Gg, Gs^Fp, Gg, Hh^Fp, Ms, Mm^Xm, Mm^Xm, Mm, Gg, Mm, Mm, Mm^Xm, Mm^Xm, Mm, Hh, Hh
Gs, Gg, Gg, Gg, Gg, Gg, Gg, Gs^Fp, Hh^Fp, Gg, Gs^Fp, Gs^Fp, Gg, Hh^Fp, Mm^Xm, Mm^Xm, Mm, Mm, Hh^Fms, Gg, Mm, Mm^Xm, Mm, Mm, Hh, Hh, Wwf
Gg^Efm, Gg, Gg, Gs^Fp, Hh^Fp, Gg^Vc, Hh, Hh^Fp, Hh^Fmw, Gs^Fp, Gs, Gg, Ce, Hh^Fp, Mm^Xm, Mm, Gs^Fp, Gs^Fp, Gg^Efm, Mm, Mm, Mm^Xm, Mm^Xm, Mm, Mm, Hh, Ww
Gg^Efm, Gg, Gg, Hh, Hh, Hh, Ms, Mm, Hh, Gs, Gg, Ce, Ke, Gg, Mm^Xm, Mm, Mm, Mm, Gg^Efm, Mm, Mm, Mm, Mm, Mm^Xm, Mm^Vhh, Gg, Wwf
Gg, Gg, Gg^Efm, Gg, Hh^Fp, Mm, Mm^Xm, Mm, Hh^Vhh, Gg, Gs, Gg, Hh, Mm, Mm, Mm^Xm, Mm^Xm, Mm, Hh, Gg^Efm, Mm, Mm, Mm^Xm, Mm^Xm, Mm, Gg, Wo
Gg, Hh, Hh, Hh, Mm, Mm^Xm, Mm, Gg, Gs, Gg, Gs, Gg, Hh, Hh^Fp, Mm, Mm, Mm^Xm, Mm, Hh, Gg^Efm, Ms, Mm^Xm, Mm^Xm, Ha, Ha, Ww, Mm
Gg, Gg, Gg^Efm, Mm, Mm^Xm, Mm^Xm, Hh^Fms, Hh, Hh, Gg, Gg, Gg, Hh, Hh^Fdw, Mm, Mm, Mm^Xm, Mm^Xm, Hh, Gg^Efm, Mm, Ms, Mm, Mm^Xm, Mm^Xm, Ms, Mm^Xm
Gg, Hh, Mm, Mm, Mm^Xm, Mm, Hh^Fdw, Hh, Gg, Gg^Efm, Gg, Gg^Efm, Mm, Gg, Mm^Xm, Mm^Xm, Hh^Fp, Mm, Gg^Efm, Gg^Efm, Mm, Mm, Mm^Xm, Mm^Xm, Ms, Mm^Xm, Mm
Hh, Hh, Mm, Ms, Ms, Mm^Xm, Mm, Gg, Gs, Gg, Gg, Hh, Hh^Vhh, Mm^Xm, Mm, Mm, Mm^Vc, Mm, Gg^Efm, Mm, Mm, Mm^Xm, Mm^Xm, Ms, Mm, Mm, Mm
Hh^Vhh, Mm, Ww, Ms, Mm, Mm^Xm, Mm, Hh, Gs, Gg, Gg, Hh, Mm, Mm^Xm, Mm^Xm, Mm, Hh, Gg^Efm, Hh, Mm, Mm, Mm^Xm, Mm, Hh, Hh, Hh^Fdw, Gg^Efm
Ss, Gg, Wwf, Mm, Mm, Mm^Xm, Mm^Xm, Mm, Hh, Gg, Gg, Gg, Mm, Mm, Mm^Xm, Mm, Hh, Gg^Efm, Hh, Mm, Mm, Mm^Xm, Mm^Xm, Hh, Mm, Hh^Fdw, Mm
Ss, Ss, Gg, Ss, Ss, Mm, Mm, Mm^Xm, Mm, Gg, Gg, Gg, Mm, Mm^Xm, Mm, Hh, Hh, Gg^Efm, Hh, Hh^Fms, Hh^Fms, Hh^Fmf, Mm^Xm, Mm, Mm^Xm, Mm, Mm
Wo, Ww, Ww, Ss, Ss, Hh, Mm, Mm^Xm, Mm^Xm, Mm, Mm, Gg, Mm, Mm^Xm, Mm, Gs^Fp, Hh^Fmw, Gg^Efm, Hh, Hh, Ms, Mm^Xm, Mm, Mm, Mm, Mm^Xm, Mm^Xm
Ss, Ss, Ww, Ss, Ww, Hh, Ss, Hh, Hh, Mm^Xm, Mm, Hh, Hh, Mm^Xm, Mm, Gg, Hh^Fmw, Hh^Vc, Ms, Mm, Ms, Mm^Xm, Mm^Xm, Ms, Ms, Mm, Mm
Ss, Ww, Gg, Ss, Gg, Ss, Wwf, Ww, Hh, Mm^Xm, Mm, Hh, Hh, Mm^Xm, Mm, Gg, Gg, Mm, Ms, Ms, Mm^Xm, Mm^Xm, Mm, Ms, Mm, Mm, Mm
Ss, Ww, Ww, Ss, Ww, Ww, Gs^Fp, Gs^Fp, Chr, Mm, Hh^Fp, Mm, Mm^Xm, Mm^Xm, Mm, Gg^Efm, Mm, Mm, Mm^Xm, Mm^Xm, Mm^Xm, Mm, Mm, Mm, Mm, Mm, Mm
Ss, Ss, Ww, Ss^Vhs, Ss, Ww, Gg, Gs^Fp, Chr, Khr, Mm^Vhh, Mm, Mm^Xm, Mm, Mm, Hh, Ms, Mm^Xm, Mm^Xm, Mm, Hh, Mm, Mm, Mm, Mm, Mm, Hh^Fds
Gg, Ss, Ww, Ww, Ss, Gg, Rb, Gs, Hh, Chr, Hh^Fmw, Mm, Mm, Mm^Xm, Mm^Xm, Mm, Mm, Mm, Hh^Fp, Mm, Hh, Gg^Efm, Hh^Fds, Mm, Hh^Vhh, Hh^Fds, Gg
Gg, Ds, Wo, Gg, Ss, Gg, Rb, Hh^Fp, Hh^Fms, Gg, Hh^Fmw, Mm, Mm, Mm^Xm, Mm, Mm, Mm, Hh, Gg^Efm, Hh, Hh^Fdw, Hh^Fms, Hh^Fdw, Hh^Fds, Gg^Efm, Gg^Efm, Gg
Ss, Gs, Ww, Ss, Rb, Rb, Gg, Gg, Gg, Gg^Efm, Mm^Vhh, Hh, Mm^Xm, Mm^Xm, Mm, Mm, Mm, Hh, Gg^Efm, Gg^Efm, Gg, Gg^Efm, Gg, Gg, Gg, Ss, Ds
Rb, Re, Ww, Rb, Gg^Efm, Ss, Ss, Gg, Gg^Efm, Hh, Hh, Hh, Mm, Mm^Xm, Mm^Xm, Mm, Hh^Fms, Hh, Gg, Gg^Efm, Ds, Gg, Ds, Gg, Ds, Ds, Ww
Gg, Ss, Ww, Gg, Gg^Efm, Gg, Gg, Gg^Efm, Hh^Fms, Gg^Efm, Gg^Efm, Hh, Mm, Mm, Mm, Mm, Ke, Gg^Efm, Gg, Gg, Ww, Ds, Ww, Ww, Wo, Ww, Wo
Ds, Ss, Ww, Ww, Ds, Ds, Ss, Hh, Gg, Gg, Gg, Hh, Hh, Mm, Mm, Mm, Ce, Ce, Gg, Ww, Wo, Ww, Wo, Wo, Wo, Wo, Ww
Ww, Ww, Ww, Ww, Gg, Gg, Gg, Hh, Gg, Gg, Gg^Efm, Gg^Efm, Hh, Hh^Fds, Mm, Mm, Gg, Gg, Ww, Ww, Ww, Wo, Wo, Wo, Wo, Ww, Wo
Ss, Ww, Ds, Ds, Ww, Ww, Gg, Gg, Gg, Gg, Wo, Gg^Efm, Gg, Hh^Fds, Hh, Mm, Gg, Gg, Ww, Wo, Wo, Wo, Wo, Wo, Wo, Ww, Ww
Ss, Gg^Efm, Ww, Ww, Wo, Ww, Ww, Gg, Ww, Ds, Gg^Efm, Gg^Vht, Gg, Gg, Gg, Hh, Ds, Ds, Wo, Wo, Wo, Wo, Wo, Wo, Wo, Wo, Ww
Ww, Ww, Wo, Ww, Wo, Wo, Wo, Ww, Wo, Ww, Ww, Ds, Ds, Ds, Ww, Ww, Wo, Ww, Ww, Wo, Wo, Wo, Wo, Wo, Wo, Wo, Ww
Ww, Wo, Wo, Wo, Wo, Wo, Wo, Wo, Wo, Wo, Wo, Ww, Wwr, Ww, Ww, Ww, Wo, Wo, Wo, Ww, Wo, Wo, Wo, Wo, Wo, Wo, Wo
