border_size=1
usage=map

Ww, Mm, Mm, Mm, Mm, Mm, Mm, Mm, Mm, Mm, Mm^Xm, Ms, Ms, Ms, Ms, Mm, Mm, Rp, Mm, Mm, Mm, Mm, Mm, Hh^Fmw, Ww, Ww, Ww, Hh, Hh, Hh, Hh, Hh, Hh, Gg, Mm, Gg, Hh^Fmw, Hh^Fmw, Hh^Fmw, Hh^Fmw, Hh^Fds
Ww, Mm, Mm, Mm, Mm, Mm, Mm, Mm, Mm, Mm, Mm^Xm, Ms, Mm, Ms, Mm, Mm, Mm, Rp, Mm, Mm, Mm, Mm, Hh^Fmw, Ww, Mm, Hh^Fmw, Hh^Fmw, Hh, Gg, Hh, Hh, Hh, Mm, Mm, Mm, Hh^Fms, Hh, Hh^Fds, Hh^Fds, Hh, Gg
Mm^Xm, Mm, Mm, Mm, Mm, Ms, Ms, Mm, Mm, Mm^Xm, Ms, Mm, Ms, Mm, Mm, Mm, Mm, Rp, Rp, Mm, Gg^Efm, Gg^Efm, Wwf, Wwf, Gg, Gg, Hh, Gg, Hh, Hh, Hh, Mm, Hh, Mm, Mm, Hh^Fms, Hh, Hh^Fmw, Hh^Fmw, Hh, Gg
Ms, Mm^Xm, Mm^Xm, Mm, Mm, Mm, Ms, Ms^Vhha, Mm, Mm^Xm, Mm, Ms, Mm, Ms^Vhha, Mm, Mm, Mm, Mm, Rp, Gg^Efm, Ww, Wwf, Gg, Gg^Efm, Gg, Gg, Hh, Hh, Gg, Hh, Mm, Mm, Hh, Mm, Mm, Hh^Fms, Hh, Hh^Fmw, Hh, Gg, Gg
Ms, Ms, Mm, Mm^Xm, Ms, Ms, Ms, Mm, Mm^Xm, Mm^Xm, Hh, Wo, Hh, Mm, Mm, Mm, Rp, Rp, Gg^Efm, Gg^Efm, Wo, Gg, Gg, Gg^Efm, Hh, Hh, Mm, Gg, Mm, Mm, Mm, Hh, Mm, Mm, Gg, Gg, Hh^Fms, Hh, Gg, Gg, Gg
Mm, Mm, Mm, Mm^Xm, Mm^Xm, Ms, Ms, Ms, Mm^Xm, Mm, Mm, Wo, Wo, Mm, Gg, Gg, Ww^Bw|, Gg^Efm, Wo, Wo, Hh, Hh, Hh, Hh, Mm, Mm, Hh, Gg, Mm, Mm, Hh, Mm, Hh, Mm, Gg, Hh, Gg^Vh, Hh, Hh^Fmw, Gg, Re^Gvs
Mm, Mm, Mm, Mm, Mm, Mm^Xm, Mm^Xm, Mm^Xm, Mm, Mm, Mm, Mm, Gg^Efm, Wo, Wo, Wo, Rp, Wo, Gg, Hh, Hh, Gg, Mm, Mm, Mm, Mm, Hh, Mm, Hh, Hh^Fms, Mm, Mm, Mm, Mm, Hh, Hh, Gg^Efm, Hh, Re^Gvs, Re^Gvs, Re^Gvs
Mm, Mm, Hh^Fdw, Mm, Mm^Xm, Mm^Xm, Mm, Mm, Mm, Mm, Gg^Efm, Mm, Gg, Gg, Rp, Rp, Gg^Efm, Hh, Hh, Hh^Vhh, Mm, Mm, Mm, Mm, Hh, Gg, Hh^Fmw, Hh, Mm, Gg, Mm, Mm, Hh^Fmf, Hh^Fms, Hh, Hh^Fms, Gg^Efm, Re^Gvs, Re^Gvs, Re^Gvs, Gg
Gs^Fp, Hh^Fp, Mm, Mm, Ms, Mm, Mm, Mm, Mm, Mm, Gg, Gg, Rp, Rp, Hh, Gg, Gg, Gg, Mm, Mm, Mm, Mm, Mm, Mm, Mm, Mm, Mm, Mm, Mm, Mm, Hh, Hh^Fms, Hh, Hh, Gg, Gg, Gg^Efm, Re^Gvs, Re^Gvs, Re^Gvs, Rp
Mm, Mm, Mm, Mm^Xm, Mm, Mm, Hh, Gg, Gg^Efm, Mm, Rp, Rp, Hh, Hh, Hh, Hh, Hh, Mm, Ms, Mm, Ms, Gg, Mm, Mm, Hh, Mm, Hh^Fmw, Hh, Hh, Mm, Mm, Hh, Gg, Hh^Fms, Hh^Fms, Gg, Gg, Gg^Efm, Gg, Gg^Efm, Rp
Mm, Mm, Mm^Xm, Mm^Xm, Ms, Mm, Hh, 1 Gg, Gg, Gg, Rp, Hh, Hh, Hh, Mm, Hh, Mm, Mm, Mm, Ms, Ha^Fma, Mm, Hh, Mm, Mm, Hh^Fmw, Ce, Ke, Ce, Hh, Hh, Hh, Hh, Gg, Hh^Fms, Gg, Gg, Gg^Efm, Rp, Rp, Gg^Vh
Mm, Mm, Mm^Xm, Mm, Hh, Gg, Hh, Gg, Gg, Gg, Rp, Mm, Mm, Mm, Mm, Mm, Mm, Mm, Mm, Mm, Gg, Hh, Hh, Gg, Mm, Hh, Hh, Ce, Gg^Efm, Hh, Hh, Mm, Mm, Hh, Hh, Gg, Gg^Efm, Gg^Efm, Rp, Gg, Gg
Mm, Mm, Mm^Xm, Ms, Hh, Gg, Gg, Gg, Gg^Efm, Gg, Rp, Gg, Hh, Mm, Mm, Mm, Mm, Mm, Hh, Gg, Hh, Gg, Gg, Hh, Mm, Hh, Gg, Gg^Efm, Gg, Hh, Gg, Hh, Hh, Mm, Hh, Gg, Gg^Efm, Gg^Efm, Rp, Gg, Gs^Fp
Mm^Xm, Mm^Xm, Mm, Ms, Mm, Gg, Gg, Gg, Gg^Efm, Gg, Rp, Gg, Hh, Mm, Hh, Mm, Hh, Hh, Gg, Hh, Gg, Gg, Rp, Hh^Fmw, Rp, Rp, Rp, Gg, Gg, Gg, Gg, Hh, Hh, Mm, Gg, Gg, Gg^Efm, Rp, Gg, Gg, Gs^Fp
Mm, Mm, Mm, Hh, Hh, Gg, Hh, Gg, Gg^Efm, Gg, Rp, Gg, Hh, Gg, Hh, Mm, Hh, Gg^Efm, Rp, Gg^Efm, Rp, Rp, Hh^Fmw, Hh^Fmw, Mm, Hh^Fmw, Hh^Fmw, Rp, Rp, Gg, Rp, Gg, Hh, Mm, Hh, Gg, Rp, Rp, Gg, Gg, Gs^Fp
Ms, Mm, Hh, Hh, Hh^Fdw, Hh^Vhh, Hh^Fp, Hh^Fp, Gg, Gg, Gg, Rp, Gg^Efm, Gg, Gg, Hh, Rp, Rp, Gg, Rp, Gg, Gg^Vh, Gs^Fds, Hh^Fmw, Gg, Hh^Fmw, Hh^Fmw, Gg, Gg, Gg, Re^Gvs, Rp, Rp, Hh, Rp, Rp, Gg, Gg, Gg, Gs^Fp, Gs^Fp
Mm, Mm, Chr, Hh, Gg, Hh^Fp, Hh^Fdw, Hh, Gg, Gg^Efm, Rp, Rp, Gg, Rp, Rp, Rp, Re^Gvs, Re^Gvs, Re^Gvs, Gg, Gs^Fds, Gg^Efm, Gg, Gg, Re^Gvs, Gg, Hh^Fmw, Gg, Re^Gvs, Re^Gvs, Re^Gvs, Re^Gvs, Gg^Efm, Rp, Gg, Gg, Gs^Fds, Gg, Gg, Gg, Gg
Mm, Khr, Hh, Hh, Gg, Gg, Gg^Efm, Gg, Rp, Rp, Gg, Gg, Gg^Efm, Gg, Gg, Gg, Re^Gvs, Re^Gvs, Re^Gvs, Gg, Gs^Fds, Gg, Gg, Gg, Gg, Gg, Gg, Gg, Re^Gvs, Re^Gvs, Re^Gvs, Gg, Gg, Gg, Gg, Gg, Gs^Fds, Gg, Gs^Fds, Gs^Fds, Gs^Fds
Mm, Chr, Hh^Fdw, Hh, Hh, Gg, Gg, Gs^Fmw, Gg, Gg, Gg, Gg, Gg, Gg, Gg^Efm, Gg, Gg, Re^Gvs, Gg, Gg, Gs^Fds, Gg^Efm, Gs^Fds, Gs^Fms, Gs^Fds, Gg, Gg, Gg^Vh, Gg, Re^Gvs, Gg, Gs^Fms, Gg, Gg, Gs^Fds, Gs^Fds, Hh^Fds, Gs^Fds, Gs^Fds, Gs^Fds, Gs^Fds
Hh, Chr, Hh, Hh, Hh^Fp, Rp, Gs^Fmw, Gs^Fds, Gg, Gs^Fds, Gs^Fds, Gg, Gg, Gg, Gs^Fds, Gg, Gg, Gg, Gg, Gs^Fp, Gg, Gg^Efm, Gg^Efm, Gs^Fds, Gg, Gs^Fds, Gs^Fds, Gg, Gs^Fds, Gg, Gs^Fds, Gs^Fds, Gs^Fds, Gs^Fds, Hh^Fds, Hh, Gs^Fds, Gs^Fds, Hh^Fds, Hh^Fp, Gs^Fds
Mm, Rp, Rp, Hh, Rp, Gs^Fp, Gs^Fp, Gs^Fds, Gs^Fds, Gg^Efm, Gs^Fds, Gs^Fds, Gs^Fds, Gs^Fds, Gs^Fds, Gs^Fds, Gs^Fds, Gg, Gs^Fms, Gs^Fp, Gg, Gg, Gg^Efm, Gg, Gg, Gs^Fds, Hh^Fp, Gs^Fds, Hh^Fp, Hh^Fp, Hh^Fp, Hh^Fp, Hh^Fds, Hh^Fp, Gs^Fds, Gs^Fds, Gs^Fds, Hh^Fds, Gs^Fds, Gs^Fds, Gs^Fds
Mm, Mm, Hh^Fdw, Hh, Gg, Gs^Fp, Gs^Fp, Gs^Fds, Gs^Fds, Gs^Fds, Gs^Fp, Gs^Fp, Gs^Fms, Gs^Fp, Gg^Efm, Gs^Fds, Gs^Fds, Gs^Fms, Gs^Fds, Gs^Fds, Gg, Gg, Gg^Efm, Gg^Efm, Gs^Fp, Gs^Fds, Hh^Fds, Hh^Fp, Hh^Vhh, Hh^Fp, Hh^Fp, Gs^Fds, Gs^Fds, Gs^Fds, Gs^Fds, Gs^Fds, Hh^Fds, Gs^Fds, Gs^Fds, Hh^Fds, Hh^Fds
Mm, Mm, Hh, Gg, Gg, Gg, Gg, Gs^Fp, Gs^Fp, Gg^Ve, Gs^Fds, Gs^Fms, Gs^Fp, Gs^Fp, Gs^Fp, Gs^Fp, Gs^Fds, Gg^Efm, Gs^Fds, Gs^Fds, Gg, Gs^Fp, Gg^Efm, Gs^Fp, Gs^Fp, Gs^Fp, Gs^Fds, Gs^Fds, Gs^Fds, Mm, Gs^Fds, Hh^Fp, Gs^Fds, Gs^Fds, Gs^Fms, Gs^Fds, Gg^Fet, Gg^Fet, Gg^Fet, Gs^Fds, Gs^Fds
Mm^Xm, Mm, Hh^Vhh, Gg, Gg, Gs^Fp, Gs^Fp, Gs^Fp, Gs^Fms, Gs^Fds, Gs^Fds, Gg^Efm, Gg^Efm, Gs^Fds, Gs^Fds, Gs^Fds, Gs^Fds, Gs^Fds, Gs^Fds, Gs^Fds, Gs^Fp, Gs^Fp, Gs^Fp, Gs^Fp, Gs^Fds, Gs^Fds, Gs^Fds, Gs^Fds, Gs^Fds, Gs^Fds, Gs^Fds, Gs^Fds, Gs^Fms, Gs^Fms, Gs^Fds, Gs^Fds, Gg^Fet, Ww, Gs^Fds, Gs^Fds, Gs^Fms
Mm^Xm, Ms, Ms, Hh^Fp, Hh^Fp, Gs^Fp, Gs^Fp, Gs^Fp, Gs^Fp, Gs^Fms, Gs^Fp, Gs^Fds, Gs^Fds, Gs^Fp, Gs^Fds, Gs^Fms, Gg^Efm, Gs^Fp, Gs^Fds, Gs^Fds, Gs^Fds, Gs^Fp, Gg^Efm, Gg^Efm, Gs^Fds, Gs^Fds, Gs^Fds, Gs^Fds, Gg^Fet, Gs^Fds, Gs^Fms, Gs^Fms, Gs^Fms, Gs^Fds, Gs^Fp, Gs^Fp, Gs^Fds, Ww, Ww, Gs^Fms, Gs^Fds
Mm^Xm, Mm, Mm, Mm, Hh, Gs^Fp, Gs^Fp, Gs^Fp, Gs^Fp, Gs^Fds, Gs^Fds, Gs^Fds, Gs^Fds, Gs^Fds, Gs^Fms, Gg^Efm, Gg^Efm, Gs^Fp, Gs^Fp, Gs^Fds, Gs^Fp, Gg^Efm, Gs^Fds, Gs^Fds, Gs^Fds, Gs^Fds, Gs^Fds, Gs^Fds, Gs^Fds, Gs^Fp, Gs^Fms, Gs^Fms, Gs^Fms, Gs^Fds, Gs^Fp, Gs^Fds, Gs^Fds, Gs^Fds, Gs^Fds, Ww, Ww
Mm^Xm, Mm, Mm, Mm, Mm, Gg, Gs^Fp, Gg^Efm, Gg^Efm, Gs^Fmw, Gs^Fds, Gs^Fp, Gs^Fds, Gs^Fms, Gs^Fms, Gg^Efm, Gs^Fds, Gs^Fds, Gs^Fds, Gs^Fds, Gs^Fds, Gs^Fp, Gs^Fds, Gs^Fp, Gs^Fds, Gs^Fds, Gs^Fms, Gs^Fds, Gs^Fms, Gs^Fms, Ce, Gs^Fds, Gs^Fds, Gs^Fds, Gs^Fds, Gs^Fp, Gs^Fds, Gs^Fds, Gs^Fds, Gs^Fds, Gs^Fds
Mm, Ms, Mm, Mm, Mm, Gs^Fp, Gs^Fmw, Gs^Fp, Gs^Fp, Gg^Efm, Gg, Gg^Efm, Gg, Gs^Fds, Gs^Fms, Gs^Fds, Gs^Fds, Gs^Fmw, Gs^Fds, Gs^Fp, Gs^Fds, Gs^Fds, Gs^Fds, Gs^Fds, Gs^Fp, Gs^Fms, Gs^Fms, Gs^Fds, Gs^Fms, Ce, 2 Ke, Ce, Gg^Fet, Gs^Fds, Gs^Fds, Gs^Fds, Gs^Fds, Gs^Fp, Gs^Fds, Gs^Fds, Gs^Fds
Mm, Mm, Mm, Mm, Gg, Gs^Fp, Gs^Fms, Gs^Fms, Gs^Fp, Gg^Efm, Gs^Fp, Gg, Gs^Fds, Gs^Fds, Gg^Efm, Gs^Fms, Gs^Fds, Gg^Efm, Gg^Efm, Gs^Fds, Gs^Fds, Gs^Fds, Gs^Fds, Gs^Fds, Gs^Fms, Gs^Fds, Gs^Fds, Gs^Fds, Gs^Fds, Ce, Ce, Ce, Re, Gs^Fds, Gs^Fds, Gs^Fds, Gs^Fds, Gs^Fds, Gs^Fds, Gs^Fds, Gs^Fds
Mm, Mm, Hh, Gg, Gg, Gs^Fp, Gs^Fp, Gs^Fmw, Gs^Fp, Gs^Fp, Gs^Fp, Gs^Fp, Gs^Fds, Gs^Fds, Gs^Fms, Gs^Fms, Gs^Fms, Gs^Fms, Gs^Fp, Gs^Fds, Gs^Fp, Gs^Fms, Gs^Fms, Gs^Fds, Gs^Fp, Gs^Fds, Gs^Fp, Gs^Fp, Gs^Fp, Gs^Fp, Gs^Fp, Gs^Fds, Gs^Fds, Re, Re, Gs^Fds, Gs^Fds, Gs^Fds, Gs^Fds, Gs^Fds, Gg^Fet
Hh, Hh, Hh, Hh, Gs^Fp, Gs^Fp, Gs^Fp, Gs^Fp, Gs^Fms, Gs^Fp, Gs^Fp, Gs^Fp, Gs^Fms, Gs^Fms, Gs^Fds, Gs^Fds, Gs^Fp, Gs^Fds, Gs^Fds, Gg^Efm, Gs^Fp, Gs^Fds, Gs^Fds, Gs^Fms, Gg^Efm, Gs^Fds, Gs^Fds, Gs^Fds, Gs^Fds, Gs^Fp, Gs^Fds, Gs^Fds, Gs^Fp, Gs^Fds, Re, Gg^Fet, Gs^Fds, Gs^Fds, Gs^Fds, Gs^Fds, Gg^Fet
Hh^Fp, Hh, Hh, Hh, Gs^Fp, Gs^Fp, Gg^Efm, Gg^Efm, Gg^Efm, Gs^Fp, Gs^Fmw, Gs^Fp, Gs^Fms, Gs^Fms, Gg^Ve, Gs^Fp, Gs^Fp, Gs^Fms, Gs^Fms, Gs^Fp, Gs^Fds, Gs^Fds, Gs^Fds, Gs^Fms, Gs^Fms, Gs^Fms, Gs^Fms, Gs^Fds, Gs^Fds, Gs^Fp, Gs^Fds, Gs^Fds, Gs^Fds, Gs^Fds, Gs^Fds, Re, Re, Gs^Fds, Gs^Fds, Gs^Fds, Gs^Fp
Hh, Hh^Fp, Hh, Gg, Gg, Gg^Efm, Gs^Fp, Gs^Fp, Gs^Fp, Gs^Fp, Gs^Fms, Gs^Fp, Gs^Fp, Gg^Efm, Gg^Efm, Gg^Fet, Gs^Fp, Gs^Fp, Gs^Fms, Gs^Fp, Gg^Efm, Gs^Fds, Gs^Fms, Gs^Fms, Gg^Efm, Gs^Fms, Gs^Fds, Gs^Fds, Gs^Fds, Gs^Fds, Gs^Fms, Gs^Fds, Gs^Fds, Hh^Fds, Hh^Fds, Hh^Fds, Hh^Fds, Re, Re, Gs^Fds, Gs^Fds
Gg^Efm, Hh^Fp, Hh, Gg, Gg^Efm, Gs^Fp, Gs^Fp, Gg^Efm, Gs^Fp, Hh^Fp, Hh^Fp, Gs^Fms, Gs^Fp, Gs^Fp, Gs^Fp, Gs^Fds, Gs^Fds, Gs^Fp, Gs^Fds, Gs^Fds, Gg^Efm, Gs^Fms, Gs^Fp, Gs^Fms, Gs^Fds, Gs^Fms, Gs^Fds, Gs^Fds, Gs^Fp, Gs^Fds, Gs^Fms, Gs^Fds, Gs^Fds, Gs^Fms, Hh^Fds, Hh^Fds, Hh^Fds, Gs^Fds, Gs^Fp, Re, Gs^Fds
Hh, Gg^Efm, Gg, Gg^Efm, Gg, Gg, Gs^Fp, Gs^Fp, Gs^Fp, Hh^Fp, Hh^Fp, Gs^Fms, Gs^Fp, Gs^Fp, Gg^Efm, Gs^Fp, Gs^Fp, Gs^Fds, Gs^Fds, Gg^Efm, Gs^Fp, Hh^Fds, Gs^Fds, Gs^Fds, Gs^Fms, Gs^Fms, Gs^Fds, Gs^Fds, Gs^Fds, Gs^Fms, Gs^Fds, Gs^Fds, Gs^Fds, Gs^Fp, Hh^Fds, Hh^Fds, Gs^Fds, Hh^Fds, Hh^Fds, Re, Re
Mm, Hh, Gg, Gg^Efm, Gg, Gg, Gg, Gs^Fp, Gs^Fms, Hh^Fp, Hh^Fp, Hh^Fp, Gs^Fp, Gs^Fp, Gs^Fp, Gs^Fp, Gs^Fms, Gs^Fms, Gs^Fds, Gs^Fp, Gs^Fms, Gs^Fds, Gs^Fds, Gs^Fms, Gs^Fds, Gs^Fms, Gg^Ve, Gs^Fds, Gs^Fds, Gs^Fms, Gs^Fds, Gs^Fds, Gs^Fms, Gs^Fds, Hh^Fds, Hh^Fds, Gs^Fds, Hh^Fds, Hh^Fds, Gs^Fds, Gs^Fds
Hh^Fmf, Hh, Hh, Gg, Gg, Gg, Gs^Fp, Gs^Fp, Gs^Fp, Gs^Fp, Hh^Fp, Hh^Fp, Gs^Fp, Gs^Fp, Gs^Fp, Gg^Fet, Gs^Fms, Gs^Fms, Gs^Fp, Gs^Fms, Gs^Fms, Gs^Fds, Gs^Fds, Gs^Fms, Gs^Fds, Gg^Fet, Gg^Fet, Gs^Fds, Gs^Fds, Gs^Fds, Gs^Fms, Gs^Fms, Gs^Fds, Gs^Fds, Gs^Fms, Hh^Fds, Gs^Fds, Hh^Fds, Gs^Fds, Gs^Fds, Hh^Fds
Hh, Hh, Hh, Gs^Fp, Gs^Fp, Gs^Fp, Gg^Efm, Gs^Fp, Gs^Fp, Gs^Fp, Gg^Efm, Hh^Fp, Gg^Efm, Gs^Fms, Gg^Efm, Gs^Fp, Gs^Fms, Gs^Fms, Gs^Fp, Gs^Fp, Gs^Fp, Gs^Fds, Gs^Fms, Gs^Fms, Gs^Fp, Gg^Fet, Gs^Fp, Gs^Fds, Gs^Fp, Gs^Fds, Gs^Fms, Gs^Fds, Gs^Fds, Gs^Fms, Gs^Fms, Gs^Fds, Hh^Fds, Gs^Fds, Gs^Fds, Gs^Fds, Gs^Fp
Hh, Hh, Hh, Gg, Gg, Gg, Gg^Efm, Gs^Fp, Gs^Fp, Gs^Fp, Gs^Fms, Gg^Efm, Hh^Fp, Gg^Efm, Gs^Fp, Gs^Fp, Gs^Fp, Gs^Fms, Gs^Fp, Gs^Fp, Gs^Fp, Gs^Fp, Gs^Fms, Gs^Fds, Gs^Fp, Gs^Fp, Gs^Fds, Gs^Fds, Gs^Fms, Gs^Fms, Gs^Fds, Gs^Fds, Gs^Fms, Gs^Fms, Gs^Fds, Hh^Fds, Hh^Fds, Hh^Fds, Gs^Fds, Gs^Fds, Gs^Fds
Hh, Hh^Fp, Hh, Gg, Gg, Gs^Fp, Gg, Gs^Fp, Gs^Fp, Gs^Fp, Gs^Fp, Gs^Fp, Hh^Fp, Gs^Fp, Gs^Fp, Gs^Fms, Gs^Fp, Gs^Fp, Gs^Fp, Gs^Fp, Gs^Fms, Gs^Fp, Gs^Fp, Gs^Fms, Gs^Fp, Gs^Fp, Gs^Fp, Gs^Fp, Gs^Fp, Gs^Fds, Gs^Fms, Gs^Fds, Gs^Fms, Gs^Fms, Gs^Fms, Gs^Fms, Gs^Fms, Hh^Fds, Hh^Fds, Gs^Fds, Gs^Fds
Hh, Hh, Hh, Gg, Gg, Gs^Fp, Gg, Gs^Fp, Gs^Fp, Hh^Fmw, Gg^Efm, Gs^Fp, Hh^Fp, Hh^Fp, Gs^Fp, Gs^Fp, Gs^Fp, Gs^Fp, Gs^Fp, Gs^Fp, Gs^Fp, Gs^Fp, Gs^Fms, Gs^Fms, Gs^Fms, Gs^Fp, Gs^Fp, Gs^Fp, Gs^Fms, Gs^Fms, Gs^Fds, Gs^Fds, Gs^Fms, Gs^Fms, Gs^Fds, Gs^Fp, Gs^Fds, Gs^Fds, Gs^Fds, Hh^Fds, Hh^Fds
Hh, Hh, Hh^Fp, Gg, Gg^Efm, Gg, Gs^Fms, Gs^Fp, Hh^Fp, Gs^Fp, Gs^Fms, Gg^Efm, Hh^Fp, Gs^Fms, Gg^Ve, Gs^Fp, Gs^Fp, Gs^Fp, Gs^Fms, Gs^Fp, Gs^Fms, Gs^Fp, Gs^Fms, Gs^Fms, Gs^Fms, Gs^Fds, Gs^Fds, Gs^Fds, Gs^Fds, Gs^Fds, Gs^Fds, Gs^Fds, Gs^Fms, Gs^Fms, Gs^Fds, Gs^Fds, Gs^Fds, Gs^Fms, Gs^Fms, Gs^Fds, Ww
Hh, Hh, Gg, Hh^Fp, Hh^Fp, Gg, Hh^Fp, Hh^Fp, Gs^Fms, Hh^Fp, Gs^Fp, Gg^Efm, Gs^Fms, Gs^Fms, Gs^Fms, Gs^Fp, Gs^Fms, Gs^Fp, Gs^Fp, Gs^Fms, Gs^Fp, Gs^Fms, Gs^Fp, Gs^Fms, Gs^Fms, Gs^Fms, Gs^Fds, Gs^Fds, Gs^Fds, Gs^Fp, Gs^Fds, Gs^Fms, Gs^Fds, Gs^Fms, Gs^Fms, Gg^Ve, Gs^Fds, Gs^Fds, Gs^Fms, Gg^Fet, Gs^Fds
Hh, Gg, Gg^Efm, Gg, Gg, Hh^Fp, Gs^Fds, Gs^Fds, Gs^Fms, Gs^Fms, Gs^Fp, Gs^Fms, Gg^Efm, Gs^Fms, Gs^Fms, Gs^Fp, Gs^Fp, Gs^Fp, Gs^Fp, Gs^Fp, Gs^Fp, Gs^Fp, Gs^Fp, Gs^Fp, Gs^Fms, Gs^Fms, Gs^Fp, Gs^Fp, Gs^Fp, Gs^Fds, Gs^Fds, Gs^Fms, Gs^Fms, Gs^Fds, Gs^Fms, Gs^Fds, Gs^Fms, Gs^Fds, Gs^Fp, Gs^Fds, Gs^Fds
Hh, Hh, Gs^Fp, Gs^Fp, Gs^Fp, Gs^Fp, Gs^Fms, Gs^Fds, Gs^Fp, Gs^Fms, Gs^Fp, Gs^Fp, Gs^Fp, Gg^Efm, Gg^Efm, Gs^Fp, Gs^Fp, Gs^Fp, Gs^Fms, Gs^Fp, Gs^Fmf, Gs^Fp, Gs^Fp, Gg^Fet, Gs^Fp, Gs^Fms, Gs^Fp, Gs^Fp, Gs^Fp, Gs^Fp, Gs^Fds, Gs^Fms, Gs^Fds, Gs^Fds, Gs^Fms, Gs^Fms, Gs^Fds, Gs^Fms, Gs^Fp, Gs^Fms, Ww
Hh, Gs^Fp, Gs^Fp, Gg^Efm, Gs^Fp, Gs^Fp, Gg^Efm, Gs^Fms, Gg^Efm, Gs^Fp, Gg, Gs^Fp, Gs^Fp, Gs^Fms, Gs^Fp, Gs^Fms, Gs^Fp, Gs^Fp, Gs^Fp, Gs^Fp, Gs^Fmf, Gs^Fp, Gs^Fp, Gs^Fp, Gs^Fp, Gs^Fms, Gs^Fp, Gs^Fp, Gs^Fds, Gs^Fp, Gs^Fp, Gs^Fp, Gs^Fp, Gs^Fds, Gs^Fms, Gs^Fds, Gs^Fds, Gs^Fp, Gs^Fp, Gs^Fp, Ww
Gg, Gg, Gg, Gg, Gg, Gs^Fp, Gg, Gs^Fds, Gg, Gs^Fp, Gg, Gg, Gg, Gs^Fp, Gg, Gg, Gg, Gs^Fp, Gs^Fp, Gs^Fp, Gs^Fp, Gs^Fmf, Gs^Fp, Gs^Fms, Gs^Fp, Gs^Fms, Gs^Fp, Gs^Fp, Gs^Fp, Gs^Fp, Gs^Fp, Gs^Fp, Gs^Fds, Gs^Fp, Gs^Fds, Gs^Fms, Gs^Fms, Gs^Fp, Gs^Fms, Gs^Fds, Gs^Fms
Hh, Gg, Gg, Gg, Hh^Fms, Gg, Gg^Efm, Gg, Gg, Gg, Gg, Gg, Gg, Gg, Gg, Gg, Gg, Gg, Gg, Gs^Fp, Gg, Gs^Fp, Gs^Fp, Gs^Fp, Gs^Fp, Gs^Fp, Gs^Fp, Gs^Fds, Gs^Fp, Gs^Fp, Gs^Fp, Gs^Fp, Gs^Fp, Gs^Fp, Gs^Fp, Gs^Fds, Gs^Fms, Gs^Fms, Gs^Fms, Gs^Fms, Gs^Fms
Gg, Hh, Hh, Gg, Gg, Hh^Fms, Gg^Efm, Gg^Efm, Gs^Fp, Gg, Gg, Gg, Hh, Gg, Gg, Gg, Gg, Gg, Gg, Gg, Gg, Gs^Fp, Gs^Fp, Gs^Fp, Gs^Fp, Gs^Fp, Gs^Fds, Gs^Fp, Gs^Fds, Gs^Fds, Gs^Fp, Gs^Fds, Gs^Fp, Gs^Fp, Gs^Fp, Gs^Fds, Gs^Fms, Gs^Fms, Gs^Fms, Gs^Fms, Gs^Fds
Gg, Gg, Gg, Hh^Fms, Gg, Gg, Gg^Efm, Gg^Efm, Gs^Fp, Gg^Efm, Gg, Hh, Hh, Gg, Gg, Gg, Gs^Fp, Gg, Gg, Gg, Gg, Gg, Gg, Gs^Fp, Gg, Gs^Fp, Gg^Efm, Gs^Fp, Gs^Fp, Gs^Fp, Gs^Fp, Gs^Fp, Gs^Fds, Gs^Fp, Gs^Fds, Gs^Fp, Gs^Fp, Gs^Fds, Gs^Fds, Gs^Fds, Gs^Fds
Gs^Fp, Gg, Gg, Hh, Hh, Gg^Efm, Gg^Efm, Gg^Efm, Gg^Efm, Gg, Gg, Hh, Gg, Gg, Gs^Fds, Gs^Fp, Gg, Gs^Fp, Hh^Vc, Gg, Gs^Fp, Gg, Gg, Gg, Gg^Efm, Gg^Efm, Gg^Efm, Gg^Efm, Gg^Efm, Gg, Gg, Gs^Fp, Gs^Fds, Gs^Fp, Gs^Fp, Gs^Fp, Gs^Fp, Gs^Fp, Gs^Fp, Gs^Fds, Gs^Fds
Gg, Gs^Fms, Gg, Gg, Hh, Gg, Gg, Gg^Efm, Gg, Gg^Efm, Gg^Efm, Gg, Gg^Efm, Gs^Fds, Wo, Wo, Ww, Gs^Fp, Hh, Gg, Gg, Gg, Gg, Gg^Efm, Gg^Efm, Gg, Gg, Gg^Efm, Gg, Gg, Gg, Gg, Gg, Gg, Gg, Hh^Fds, Gg, Gs^Fp, Gs^Fp, Gs^Fp, Gs^Fds
Gg, Gs^Fds, Gg, Gg, Gg, Gg, Gg, Gg, Gg, Gg^Efm, Gg, Gg^Efm, Gg, Gs^Fds, Ww, Ww, Gg^Efm, Hh, Hh^Fmw, Gg^Efm, Gg, Gs^Fp, Gg, Gg, Gg, Gg^Efm, Gg, Gg, Gg, Gg, Gg^Vc, Gg, Gg, Gg, Gg^Efm, Gg, Gg, Gg, Gg, Gg, Gg
