border_size=1
usage=map

Mm          , Hh          , Hh          , Gg          , Gg^Efm      , Gg          , Gg          , Re^Gvs      , Re^Gvs      , Re^Gvs      , Re^Gvs      , Re^Gvs      , Re^Gvs      , Re^Gvs      , Ww          , Ww          , Gg^Wm       , Re^Gvs      , Re^Gvs      , Re^Gvs      , Re^Gvs      , Re^Gvs      , Re^Gvs      , Re^Gvs      , Re^Gvs      , Re^Gvs      , Re^Gvs      
Mm          , Mm          , Mm          , Hh          , Hh          , Gg^Efm      , Gg          , Gg^Efm      , Gg          , Re^Gvs      , Re^Gvs      , Re^Gvs      , Ww          , Ww          , Re^Gvs      , Re^Gvs      , Re^Gvs      , Re^Gvs      , Re^Gvs      , Re^Gvs      , Re^Gvs      , Re^Gvs      , Re^Gvs      , Re^Gvs      , Re^Gvs      , Re^Gvs      , Re^Gvs      
Mm          , Mm          , Mm          , Hh          , Hh^Fms      , Hh          , Hh          , Gg          , Gg          , Gg          , Ww          , Ww          , Re^Gvs      , Re^Gvs      , Re^Gvs      , Re^Gvs      , Re^Gvs      , Re^Gvs      , Re^Gvs      , Re^Gvs      , Re^Gvs      , Re^Gvs      , Re^Gvs      , Re^Gvs      , Re^Gvs      , Re^Gvs      , Gg          
Mm          , Mm          , Mm          , Hh^Fp       , Hh          , Gg^Efm      , Gg^Efm      , Hh          , Gg^Efm      , Ww          , Gg^Wm       , Gg^Efm      , Ww          , Re^Gvs      , Re^Gvs      , Re^Gvs      , Re^Gvs      , Re^Gvs      , Re^Gvs      , Re^Gvs      , Re^Gvs      , Re^Gvs      , Re^Gvs      , Re^Gvs      , Gg          , Gg          , Gg          
Mm          , Mm          , Hh^Fms      , Hh^Fp       , Hh          , Hh^Fms      , Hh          , Gg^Fet      , Gg^Efm      , Ww          , Gg^Efm      , Ww          , Ww          , Ww          , Gg          , Re^Gvs      , Re^Gvs      , Re^Gvs      , Re^Gvs      , Re^Gvs      , Re^Gvs      , Re^Gvs      , Gg          , Gg          , Gg          , Gg          , Gs          
Ww          , Ww          , Ww          , Hh^Fms      , Ww          , Hh          , Ww          , Gg^Efm      , Ww          , Ww          , Gg          , Gg          , Gg          , Gg          , Ds          , Gg          , Gg          , Re^Gvs      , Re^Gvs      , Re^Gvs      , Gg          , Gg          , Gg^Wm       , Gg          , Gs          , Gs          , Gs          
Mm          , Mm          , Mm          , Ww          , Gg          , Ww          , Hh          , Ww          , Gg          , Gg          , Gg^Efm      , Gg          , Ds          , Ds          , 1 Ds        , Ds          , Gg^Efm      , Gg^Efm      , Gg^Vh       , Gg          , Gg          , Gg          , Gg          , Gs          , Gs          , Gs          , Gg          
Mm          , Mm          , Mm          , Hh^Fms      , Mm          , Hh          , Hh          , Gg          , Hh          , Gg^Efm      , Gg^Efm      , Gg          , Ds          , Ds          , Ds          , Ds          , Rd          , Rd          , Gg^Efm      , Re          , Re          , Gg          , Re          , Gg          , Gg          , Gs          , Gs          
Mm          , Mm          , Mm          , Hh          , Mm          , Mm          , Hh          , Hh          , Gg          , Gg          , Gg          , Gg          , Gg          , Ds          , Ds          , Ds          , Gg          , Gg          , Gg          , Gg          , Gg          , Re          , Gg          , Re          , Re          , Re          , Re          
Mm          , Mm          , Mm          , Mm          , Hh^Fp       , Hh          , Hh          , Hh          , Gg          , Gg^Efm      , Gg^Efm      , Gg          , Gg          , Gg          , Gg          , Gg          , Gg          , Gg          , Gg          , Gg          , Gs          , Gg          , Gs          , Gg          , Gg          , Gs          , Gs          
Mm          , Mm          , Mm          , Mm          , Hh          , Hh          , Gg^Efm      , Hh          , Hh          , Gg          , Gg          , Gg          , Gg          , Gg          , Gg          , Gg          , Gs          , Gs          , Gs          , Gs          , Gs          , Gs          , Gg          , Gs          , Gs          , Gs          , Gs          
Hh          , Mm          , Mm          , Hh          , Hh          , Hh          , Hh          , Gg^Efm      , Hh          , Gg          , Gg          , Gg          , Gg          , Gg          , Gs          , Gs          , Gs          , Gs          , Gs          , Gs          , Gs          , Gs          , Gs          , Gs          , Gs          , Gs          , Gs          
Mm          , Mm          , Gs^Fmw      , Hh^Fp       , Gg^Efm      , Gg^Efm      , Hh          , Hh          , Gs^Fds      , Gs^Fp       , Hh          , Gg          , Gg          , Gg          , Gs          , Gs          , Gs          , Gs          , Gs          , Gs          , Gs          , Gs          , Gg          , Gs          , Gs          , Gs          , Gs          
Mm          , Mm          , Gs^Fmw      , Hh          , Hh          , Hh          , Gg          , Gs^Fds      , Gs^Fp       , Gs^Fp       , Hh          , Gg          , Gg          , Gs          , Gs          , Gs          , Gg          , Gg          , Gg          , Gg          , Gg          , Gs          , Gs          , Gs          , Gs          , Gs          , Gs          
