border_size=1
usage=map

Hh, Gg, Gg^Efm, Gg, Gg, Hh^Fp, Gs^Fds, Gs^Fds, Gs^Fms, Gs^Fms, Gs^Fp, Gs^Fms, Gg^Efm, Gs^Fms, Gs^Fms, Gs^Fp, Gs^Fp, Gs^Fp, Gs^Fp, Gs^Fp, Gs^Fp, Gs^Fp, Gs^Fp, Gs^Fp, Gs^Fms, Gs^Fms, Gs^Fp, Gs^Fp, Gs^Fp, Gs^Fds, Gs^Fds, Gs^Fms, Gs^Fms, Gs^Fds, Gs^Fms, Gs^Fds, Gs^Fms, Gs^Fds, Gs^Fp, Gs^Fds, Gs^Fds
Hh, Hh, Gs^Fp, Gs^Fp, Gs^Fp, Gs^Fp, Gs^Fms, Gs^Fds, Gs^Fp, Gs^Fms, Gs^Fp, Gs^Fp, Gs^Fp, Gg^Efm, Gg^Efm, Gs^Fp, Gs^Fp, Gs^Fp, Gs^Fms, Gs^Fp, Gs^Fmf, Gs^Fp, Gs^Fp, Gg^Fet, Gs^Fp, Gs^Fms, Gs^Fp, Gs^Fp, Gs^Fp, Gs^Fp, Gs^Fds, Gs^Fms, Gs^Fds, Gs^Fds, Gs^Fms, Gs^Fms, Gs^Fds, Gs^Fms, Gs^Fp, Gs^Fms, Ww
Hh, Gs^Fp, Gs^Fp, Gg^Efm, Gs^Fp, Gs^Fp, Gg^Efm, Gs^Fms, Gg^Efm, Gs^Fp, Gg, Gs^Fp, Gs^Fp, Gs^Fms, Gs^Fp, Gs^Fms, Gs^Fp, Gs^Fp, Gs^Fp, Gs^Fp, Gs^Fmf, Gs^Fp, Gs^Fp, Gs^Fp, Gs^Fp, Gs^Fms, Gs^Fp, Gs^Fp, Gs^Fds, Gs^Fp, Gs^Fp, Gs^Fp, Gs^Fp, Gs^Fds, Gs^Fms, Gs^Fds, Gs^Fds, Gs^Fp, Gs^Fp, Gs^Fp, Ww
Gg, Gg, Gg, Gg, Gg, Gs^Fp, Gg, Gs^Fds, Gg, Gs^Fp, Gg, Gg, Gg, Gs^Fp, Gg, Gg, Gg, Gs^Fp, Gs^Fp, Gs^Fp, Gs^Fp, Gs^Fmf, Gs^Fp, Gs^Fms, Gs^Fp, Gs^Fms, Gs^Fp, Gs^Fp, Gs^Fp, Gs^Fp, Gs^Fp, Gs^Fp, Gs^Fds, Gs^Fp, Gs^Fds, Gs^Fms, Gs^Fms, Gs^Fp, Gs^Fms, Gs^Fds, Gs^Fms
Hh, Gg, Gg, Gg, Hh^Fms, Gg, Gg^Efm, Gg, Gg, Gg, Gg, Gg, Gg, Gg, Gg, Gg, Gg, Gg, Gg, Gs^Fp, Gg, Gs^Fp, Gs^Fp, Gs^Fp, Gs^Fp, Gs^Fp, Gs^Fp, Gs^Fds, Gs^Fp, Gs^Fp, Gs^Fp, Gs^Fp, Gs^Fp, Gs^Fp, Gs^Fp, Gs^Fds, Gs^Fms, Gs^Fms, Gs^Fms, Gs^Fms, Gs^Fms
Gg, Hh, Hh, Gg, Gg, Hh^Fms, Gg^Efm, Gg^Efm, Gs^Fp, Gg, Gg, Gg, Hh, Gg, Gg, Gg, Gg, Gg, Gg, Gg, Gg, Gs^Fp, Gs^Fp, Gs^Fp, Gs^Fp, Gs^Fp, Gs^Fds, 1 Gs^Fp, Gs^Fds, Gs^Fds, Gs^Fp, Gs^Fds, Gs^Fp, Gs^Fp, Gs^Fp, Gs^Fds, Gs^Fms, Gs^Fms, Gs^Fms, Gs^Fms, Gs^Fds
Gg, Gg, Gg, Hh^Fms, Gg, Gg, Gg^Efm, Gg^Efm, Gs^Fp, Gg^Efm, Gg, Hh, Hh, Gg, Gg, Gg, Gs^Fp, Gg, Gg, Gg, Gg, Gg, Gg, Gs^Fp, Gg, Gs^Fp, Gg^Efm, Gs^Fp, Gs^Fp, Gs^Fp, Gs^Fp, Gs^Fp, Gs^Fds, Gs^Fp, Gs^Fds, Gs^Fp, Gs^Fp, Gs^Fds, Gs^Fds, Gs^Fds, Gs^Fds
Gs^Fp, Gg, Gg, Hh, Hh, Gg^Efm, Gg^Efm, Gg^Efm, Gg^Efm, Gg, Gg, Hh, Gg, Gg, Gs^Fds, Gs^Fp, Gg, Gs^Fp, Hh^Vc, Gg, Gs^Fp, Gg, Gg, Gg, Gg^Efm, Gg^Efm, Gg^Efm, Gg^Efm, Gg^Efm, Gg, Gg, Gs^Fp, Gs^Fds, Gs^Fp, Gs^Fp, Gs^Fp, Gs^Fp, Gs^Fp, Gs^Fp, Gs^Fds, Gs^Fds
Gg, Gs^Fms, Gg, Gg, Hh, Gg, Gg, Gg^Efm, Gg, Gg^Efm, Gg^Efm, Gg, Gg^Efm, Gs^Fds, Wo, Wo, Ww, Gs^Fp, Hh, Gg, Gg, Gg, Gg, Gg^Efm, Gg^Efm, Gg, Gg, Gg^Efm, Gg, Gg, Gg, Gg, Gg, Gg, Gg, Hh^Fds, Gg, Gs^Fp, Gs^Fp, Gs^Fp, Gs^Fds
Gg, Gs^Fds, Gg, Gg, Gg, Gg, Gg, Gg, Gg, Gg^Efm, Gg, Gg^Efm, Gg, Gs^Fds, Ww, Ww, Gg^Efm, Hh, Hh^Fmw, Gg^Efm, Gg, Gs^Fp, Gg, Gg, Gg, Gg^Efm, Gg, Gg, Gg, Gg, Gg^Vc, Gg, Gg, Gg, Gg^Efm, Gg, Gg, Gg, Gg, Gg, Gg
Gs^Fp, Gs^Fp, Gs^Fp, Gs^Fp, Gg^Efm, Gg, Gg, Gs^Fds, Gg, Gg, Gg, Gg, Gg, Gg, Gg, Gg, Gg, Hh, Gg, Gg, Hh, Gg, Gg, Gg, Gg, Gg, Hh, Gg, Hh^Fdw, Gg, Gg, Hh, Gg, Gg, Gg, Gg^Efm, Gg^Efm, Gg, Gs^Fp, Gg, Gg^Vc
Gg, Gg, Gg, Ss, Gg, Gg^Efm, Ss, Gg, Gg, Gg, Gg, Gg, Gg, Gg, Gg, Gg, Hh^Fmw, Gg, Gg, Gg, Gg, Hh, Gg, Gg, Gg, Gg, Hh, Hh, Gg, Hh, Hh^Fdw, Gs, Gg, Gg^Efm, Gg^Efm, Gs^Fp, Gs^Fdw, Gs^Fdw, Gs^Fdw, Gg, Re^Gvs
Ss, Ss, Gg, Ss, Gg, Ss^Vhs, Ss, Gg, Ss, Gg, Ss, Gg, Gg, Gg, Ce, Gg, Hh, Gg, Gg^Vh, Gg, Gs^Fmw, Gg, Gg, Gg, Gg, Gg, Gs, Gg, Gs, Gs, Gs, Gg, Gs, Gs, Gs, Gs, Gg^Efm, Gs^Fdw, Gs, Gg, Re^Gvs
Ds, Gg, Ss, Ss, Gg, Gg, Ss, Gg, Ss, Ss, Ss, Hh, Hh, Ce, 3 Ke, Ce, Hh, Gg, Gs, Gs^Fmw, Gg^Efm, Gg^Efm, Gg^Efm, Gg, Gg, Gg, Gg^Efm, Gs, Gg, Gs, Gg, Gs, Gs, Gs, Hh^Fmw, Gs, Gs^Fp, Gs^Fdw, Gg^Efm, Gg^Efm, Gg
Ds, Gg, Gg, Ss, Ss, Ss, Ss, Gg, Ss, Ss, Ss, Gg, Gg, Hh, Mm, Hh, Mm, Gs, Gg, Gg^Efm, Gg^Efm, Gg^Efm, Gs, Gs, Gg, Gs, Gs, Gg, Gs, Gg, Gs, Gg, Gs, Gg, Gg, Gg, Gg, Gg^Efm, Gg, Gg, Gg^Efm
Ds, Ss, Gg, Gg, Gg, Ss, Ss, Gg, Gg, Gg, Gg, Gg, Gg, Hh, Hh, Mm, Mm, Gs, Gs, Gs, Gs, Gs, Gg, Gs, Gs, Gs, Gs^Fdw, Gs, Gs, Gg, Gs, Gg, Gs, Gs, Gs, Gs, Gg^Efm, Gs, Gg, Gg, Hh
Ds, Gg, Gg, Ds, Ss, Ss, Gg, Ss, Ss, Ss, Wwf, Gg, Ss, Gg, Hh, Hh, Hh^Fdw, Gg^Efm, Gg^Efm, Gg^Efm, Gs, Gs, Gs, Gs, Gs, Gg^Vh, Gs^Fdw, Gg, Gs, Gs, Gs, Gs, Gs, Gg, Gg, Hh, Hh^Fmw, Gg, Hh^Fdw, Hh, Gg^Efm
Ww, Ds, Gg, Ss, Ss, Gg, Ss, Gg, Ss, Ss, Ss^Vhs, Ww, Gg, Hh, Gg, Hh, Hh^Fdw, Gg, Hh, Gg^Efm, Gg^Efm, Gs, Gs, Gg, Gg, Gg^Efm, Gs, Gs, Gs, Gs, Gs, Gs, Gg^Efm, Gg, Hh, Hh^Fdw, Hh, Hh^Fdw, Hh^Fdw, Hh^Fdw, Gg^Efm
Ww, Ds, Gg, Gg, Ss, Gg, Ss, Wo, Ss, Ss, Gg, Ss, Ss, Gg, Gg, Gg, Hh, Hh, Hh^Vc, Hh^Fdw, Gg^Efm, Gs, Gg, Gg, Gg, Gg, Gs, Gs, Gs, Gs, Gg, Gs, Gs, Hh, Gg^Vc, Hh, Gg, Ds, Gs, Hh, Gs
Ds, Ww, Gg, Gg, Gg, Ss, Wo, Wo, Ww, Ss, Ww, Wo, Wwf, Gg, Gg, Gg, Hh, Mm, Mm, Hh^Fdw, Gg^Efm, Gs, Gs, Gs, Gs, Gg, Gs, Gs, Gs, Gs, Gg, Hh, Gg, Gg, Hh^Fmw, Ds, Hh, Gg, Hh, Hh^Fdw, Gs
Ww, Ww, Ww, Ds, Ss, Ss, Wwf, Ww, Gg, Ww, Ss, Ww, Ss, Wwf, Ww, Hh, Mm, Hh, Mm, Hh, Gg^Efm, Gs, Gs, Gs, Gs, Gs, Ds, Gs, Gs, Gs, Gg, Hh, Hh^Fdw, Hh^Fdw, Gg^Efm, Gs, Gg, Ds, Hh, Hh, Hh
Wo, Wo, Ww, Ww, Ss, Wwf, Gg, Ds, Ss, Gg, Ss, Ss, Gg, Gg, Hh^Fp, Ww, Ms, Ms, Mm, Mm, Mm, Gg^Efm, Gg^Efm, Gs, Gs, Ds, Gs, Gs, Gs, Gg, Ce, Hh, Hh, Hh, Gg, Hh, Gg, Gg, Gg, Hh, Hd
Wo, Wo, Ww, Ss, Ww, Ww, Ds, Ss, Gg, Ss, Gg, Gg, Gg, Hh^Fdw, Hh^Fdw, Hh^Fms, Ms, Mm, Hh^Fdw, Mm, Mm, Hh, Gs, Gs, Gs, Gs, Gs, Gs, Gs, Ce, 4 Ke, Ce, Hd, Gg, Gg, Hh, Hh, Hh, Hh^Fdw, Hh, Ds
Wo, Wo, Ww, Ww, Wo, Ww, Ww, Gg, Gg, Ss, Ds, Gg, Hh, Hh, Hh^Fdw, Hh^Fp, Mm, Hh^Fdw, Mm, Hh, Ce, Mm, Gg, Gg, Gs, Gs, Gs, Gg, Gg, Gg, Hh, Ds, Gs, Hd, Hh, Hd, Hh^Fdw, Hd, Gs, Hd, Ds
Wo, Wo, Wo, Wo, Wo, Ww, Ww, Ww, Ww, Ds, Ds, Gg, Hh, Hh, Hh^Fdw, Hh, Mm, Hh^Fdw, 5 Ke, Ce, Ce, Gg, Gg^Efm, Gg, Ds, Gs, Hh, Hh, Hh, Hh, Gs, Ds, Hh, Hh, Ds, Hh, Ds, Hh, Ds, Ds, Ds
Wo, Wo, Ww, Ss, Ss, Gg, Gg, Gg, Gg, Gg, Gg, Gg^Efm, Gg^Efm, Gg, Hh, Gg, Hh, Ms, Hh, Ce, Gs, Gg^Efm, Gg^Efm, Gs, Gs, Gs, Gs, Gs, Ds, Gs, Gs, Ds, Ds, Gs, Gs, Ds, Gs, Gs, Ds, Hd, Hd
Wo, Wo, Ww, Gg, Gg, Ss, Ss, Gg, Ss, Gg, Gg, Gg, Gs, Gg, Hh, Gg, Gg, Mm, Hh, Gs, Gg^Efm, Gg^Efm, Gg, Gg, Gs, Ds, Ds, Gs, Gs, Ds, Gs, Ds, Ds, Hh, Ds, Gs, Ds, Ds, Hd, Gs, Ds
Wo, Wo, Ww, Gg, Ss, Ss, Ss, Ss, Gg, Ss, Ss, Gg, Hh, Gs, Hh^Fds, Hh^Fds, Hh, Mm, Hh^Fdw, Gs, Gs, Hh, Gs, Ds, Gs, Gs, Ds, Ds, Ds, Ds, Gs, Gs, Gs, Ds, Ds, Hd, Gs, Ds, Hd, Ds, Ds
Wo, Ww, Ww, Ds, Ds, Ss, Gg, Gg, Ss, Ss, Hh, Gg, Gg, Gs, Hh, Ww, Mm, Mm, Re, Re, Re, Gs, Ds, Ds, Ds, Gs, Gs, Gs, Gs, Ds, Ds, Gs, Ds, Gs, Gs, Hh, Gs, Gs, Ds, Ds, Gs
Wo, Wo, Wo, Ww, Ss, Ss, Gg, Hh, Ss, Gg, Gg, Hh, Ss, Ss, Gg, Hh, Mm, Mm, Gg, Hh, Hh, Re, Gs, Re, Ds, Re, Re, Gs, Ds, Ds, Ds, Ds, Ds, Ds, Hd, Ds, Ds, Ds, Ds, Gs, Ds
Ss, Wo, Wo, Ww, Ww, Ds, Ss, Gg, Gg, Hh, Ss, Ss, Ss, Gg, Gg, Hh, Re, Re, Mm, Hh, Hh, Hh, Gs, Ds, Ds, Gs, Ds, Re, Ds, Ds, Gs, Ds, Ds, Hd, Ds, Ds, Ds, Gg^Efm, Ds, Ds, Ds
Ss, Wo, Ww, Ww, Ww, Ss, Ss, Gg, Ss, Gg, Ss, Gg, Gg, Hh, Gg, Re, Hh, Hh, Mm, Mm, Mm, Hh, Gs, Ds, Gs, Gs, Gs, Ds, Ds, Ds, Re, Re, Re, Ds, Ds, Ds, Ds, Dd^Do, Ds, Ds, Ds
Ds, Gg, Wo, Wo, Wo, Ww, Ss, Ss, Gg, Ss, Ss, Ss, Ss, Gg, Gg, Hh, Hh, Gg, Hh, Mm, Mm, Mm, Gs, Ds, Hd, Ds, Gs, Ds, Ds, Ds, Ds, Ds, Ds, Ds, Ds, Ds, Ds, Dd^Vda, Ds, Ds, Ds
Ds, Gg, Gs^Vht, Wo, Wo, Ww, Ss, Gg, Ss, Gg, Ss, Ss^Vm, Ss, Gg, Gg, Hh, Gg, Hh, Hh, Hh, Mm, Hh, Hh^Vc, Mm, Hh, Ds, Hh, Ds, Ds, Ds, Ds, Ds, Ds, Ds, Hd, Ds, Re, Re, Re, Ds, Re
Ds, Ss, Gg, Ww, Wo, Wo, Wo, Gg, Gg, Gg, Ss, Gg, Ww, Ww, Ww, Gg, Hh, Hh, Hh, Hh, Mm, Hh, Hh^Fdw, Mm, Mm, Hh, Hd, Ds, Ds, Dd^Vdt, Ds, Ds, Ds, Ds, Hd, Hd, Md, Hd, Hd, Re, Hd
Ds, Gg, Gg, Ww, Wo, Wo, Wo, Ss, Ss, Ss, Ww, Ss, Ww, Ss, Wwf, Gg, Hh, Hh^Vc, Mm, Mm, Hh, Hh, Mm, Mm, Mm, Hh, Hd, Hd, Ds, Ds, Ds, Ds, Hd, Hd, Md, Md, Md, Hd, Hd, Hd, Hd
Ww, Ds, Ww, Ww, Wo, Wo, Wo, Ds, Ww, Ww, Ss^Vhs, Ww, Gg, Wwf, Gg, Wo, Ww, Mm, Mm, Hh, Hh, Hh, Mm, Mm, Gg, Hd, Hd, Hh, Hd, Ds, Ds, Ds, Hd, Hd, Md, Md, Ds, Hd, Hd, Hd, Hd
