border_size=1
usage=map

Re          , Gs^Fp       , Gs^Fp       , Gs^Fp       , Gs^Fp       , Gs^Fp       , Gs^Fp       , Gs^Fp       , Gs^Fp       , Gg^Efm      , Gg          , Gg          , Gs^Fms      , Gs^Fms      , Gs          , Gg^Efm      , Gs          , Gg          , Gs          , Gg          , Gg^Efm      , Gs^Fp       , Gs^Fp       , Gs^Fp       , Wo          , Hh          , Mm          , Mm          , Mm          , Mm          , Mm          , Mm          , Mm          , Mm          , Mm          , Mm          , Mm          , Hh^Fp       , Mm          , Mm          , Ww          , Mm          , Mm          , Mm          , Mm          , Mm          , Mm          , Mm          , Mm          , Mm          
Re          , Gs^Fp       , Gs^Fp       , Gs^Fp       , Gs^Fp       , Gs^Fp       , Gs^Fp       , Gs^Fp       , Gs^Fp       , Gg^Efm      , Gg^Efm      , Gg^Efm      , Gg          , Gs^Fms      , Hh          , Gs^Fms      , Hh          , Gs          , Hh          , Gg          , Gg^Efm      , Gs^Fp       , Wo          , Wo          , Ce          , Ke          , Hh          , Mm          , Hh^Fp       , Hh^Fp       , Hh^Fp       , Mm          , Mm          , Mm          , Mm          , Mm          , Hh^Fp       , Hh^Vhh      , Ms          , Mm          , Ww          , Mm          , Mm          , Mm          , Mm          , Mm          , Mm          , Mm          , Mm          , Mm          
Re          , Gs^Fp       , Gs^Fms      , Gg^Efm      , Gs^Fms      , Gs^Fds      , Gs^Fp       , Gs^Fp       , Gs^Fp       , Gs^Fp       , Gs^Fp       , Gg^Efm      , Gg          , Hh          , Mm          , Hh^Fdw      , Hh^Fp       , Hh          , Gg^Efm      , Gg^Efm      , Ww          , Wo          , Ww          , Gg          , Gg          , Ce          , Ww          , Gg          , Wo          , Mm          , Hh^Fp       , Mm          , Mm          , Mm          , Mm          , Hh^Fp       , Hh^Fp       , Ms          , Ms          , Ms          , Mm^Xm       , Mm          , Mm          , Mm          , Mm          , Ms          , Ms          , Mm          , Mm          , Mm^Xm       
Gs^Fp       , Gs^Fp       , Hh^Fp       , Gs^Fp       , Gs^Fms      , Gs^Fp       , Gs^Fp       , Gg^Efm      , Gs^Fp       , Gs^Fp       , Gs^Fp       , Gg^Efm      , Gg          , Hh^Fp       , Mm          , Ms          , Hh^Fp       , Hh          , Ww          , Ww          , Gg^Efm      , Gg^Vh       , Gg          , Ww          , Wo          , Ww          , Gg^Efm      , Ww          , Hh          , Ww          , Ww          , Mm          , Mm          , Mm          , Hh^Fp       , Hh^Fp       , Ms          , Ms          , Mm          , Mm^Xm       , Ms          , Mm^Xm       , Mm^Xm       , Mm          , Mm          , Mm          , Ms          , Ms^Vhha     , Mm          , Mm^Xm       
Gs^Fp       , Gs^Fds      , Gs^Fp       , Gs^Fp       , Gs^Fp       , Gg^Fet      , Gs^Fp       , Gg^Efm      , Gs^Fp       , Gs^Fds      , Gg^Fet      , Gs^Fp       , Hh^Fp       , Mm          , Ms          , Ms          , Hh^Fp       , Gg^Efm      , Ww          , Gg^Efm      , Gg          , Gg^Efm      , Gg^Efm      , Hh          , Gg^Efm      , Gg          , Hh          , Hh          , Mm          , Gg          , Gg          , Ww          , Ww          , Ww          , Ww          , Mm          , Wo          , Mm          , Mm          , Ha          , Ms          , Ms          , Mm          , Mm^Xm       , Ms          , Ms          , Ms          , Mm          , Mm^Xm       , Mm^Xm       
Gs^Fms      , Gs^Fms      , Gs^Fp       , Gs^Fp       , Gs^Fp       , Gs^Fds      , Gs^Fp       , Gs^Fp       , Gg^Fet      , Gs^Fds      , Gs^Fp       , Gs^Fp       , Hh^Fp       , Mm          , Ms          , Ha^Fma      , Wo          , Wo          , Gg^Efm      , Gg^Efm      , Gg          , Gs          , Gg^Efm      , Hh          , Hh          , Gg^Efm      , Gg^Efm      , Gg          , Mm          , Hh          , Hh          , Hh          , Gg          , Gs          , Gs          , Ww          , Gs^Fp       , Mm          , Hh^Fp       , Mm          , Mm          , Mm          , Mm          , Mm^Xm       , Mm^Xm       , Ms          , Ms          , Ms          , Mm^Xm       , Mm          
Gs^Fp       , Gs^Fms      , Gs^Fp       , Hh^Fp       , Gg^Efm      , Gs^Fp       , Gs^Fp       , Gs^Fp       , Gs^Fms      , Gs^Fms      , Gs^Fms      , Gs^Fms      , Gg^Efm      , Mm          , Mm          , Ms          , Hh^Fp       , Wo          , Ww          , Gg^Efm      , Gg          , Gs          , Gs          , Gg          , Gg          , Gg          , Gs          , Hh          , Hh          , Mm          , Mm          , Hh          , Hh          , Gg          , Gs          , Gg^Efm      , Hh^Fp       , Hh^Fp       , Hh^Fp       , Mm          , Mm          , Mm          , Mm          , Mm          , Mm          , Mm^Xm       , Mm^Xm       , Mm^Xm       , Mm          , Mm          
Gs^Fp       , Gs^Fms      , Gs^Fp       , Gs^Fp       , Gs^Fp       , Gs^Fp       , Gs^Fp       , Gs^Fp       , Gs^Fms      , Gs^Fp       , Gs^Fds      , Gg^Efm      , Hh          , Hh^Fp       , Hh^Fp       , Mm          , Gg^Efm      , Gg^Efm      , Ww          , Gg^Efm      , Gg^Efm      , Gg^Efm      , Gg^Efm      , Gg          , Gg          , Gg          , Gg^Efm      , Hh          , Mm          , Mm          , Mm          , Mm          , Gg          , Gg          , Gg^Efm      , Gg          , Gg^Efm      , Gg^Efm      , Gs^Fp       , Hh^Fp       , Mm          , Mm          , Hh^Fdw      , Mm          , Mm^Xm       , Mm^Xm       , Mm          , Mm          , Mm          , Mm          
Gs^Fms      , Gs^Fp       , Gs^Fms      , Gg^Ve       , Hh^Fp       , Gs^Fp       , Gs^Fds      , Gs^Fp       , Gs^Fp       , Gs^Fp       , Gg^Fet      , Gg^Efm      , Gg^Efm      , Hh^Fp       , Mm          , Hh^Fms      , Hh          , Gs^Fp       , Wo          , Mm          , Gg^Efm      , Gg          , Gg          , Hh          , Gg^Efm      , Gg          , Gg^Efm      , Hh          , Hh          , Mm          , Ms          , Mm          , Mm          , Gg          , Gg          , Gg          , Gs          , Gg^Efm      , Gg^Efm      , Gs^Fp       , Gs^Fp       , Hh^Fp       , Mm          , Mm          , Ms          , Mm          , Mm          , Mm          , Mm          , Mm          
Gs^Fp       , Gs^Fds      , Gs^Fp       , Gs^Fms      , Hh^Fp       , Gs^Fp       , Gs^Fms      , Gs^Fp       , Gs^Fp       , Gs^Fp       , Gg^Efm      , Gg^Efm      , Gg          , Hh^Fp       , Mm          , Ms          , Hh          , Hh          , Ww          , Mm          , Gg^Efm      , Hh          , Gg^Efm      , Gg          , Gg          , Gg          , Hh          , Gg          , Hh          , Mm          , Ms          , Ms          , Mm          , Hh          , Hh          , Gg^Efm      , Hh          , Hh^Fms      , Hh          , Gg^Efm      , Mm          , Mm          , Mm          , Mm^Xm       , Mm          , Mm          , Hh          , Gg          , Gg^Efm      , Mm          
Gg^Fet      , Gs^Fp       , Gs^Fp       , Gs^Fp       , Hh^Fp       , Gs^Fms      , Gs^Fp       , Gs^Fp       , Gs^Fp       , Gs^Fds      , Gg^Efm      , Gg^Efm      , Gs^Fms      , Gg          , Hh^Fp       , Ms          , Ms          , Mm          , Ww          , Gg^Efm      , Gg^Efm      , Gg^Efm      , Gg^Efm      , Gg          , Gg^Efm      , Gg^Efm      , Hh          , Gg^Efm      , Mm          , Mm          , Mm          , Ms          , Mm          , Mm          , Hh          , Gg          , Gs          , Hh          , Gg^Efm      , Gg^Efm      , Mm          , Mm          , Mm^Xm       , Mm^Xm       , Ms          , Mm          , Hh          , Gg          , Gg          , Gg          
Gs^Fp       , Gs^Fp       , Gs^Fms      , Hh^Fp       , Gs^Fms      , Gs^Fds      , Gg^Efm      , Gs^Fp       , Gs^Fp       , Gs^Fp       , Gg^Efm      , Gg^Efm      , Gg          , Gg^Efm      , Hh          , Mm          , Mm          , Ms          , Hh^Fms      , Ww          , Ww          , Gg^Vh       , Mm          , Mm          , Gg^Efm      , Gg          , Gg^Efm      , Gg^Vh       , Mm          , Mm          , Mm          , Ms          , Mm          , Mm          , Gg^Efm      , Gg^Efm      , Hh          , Gg^Efm      , Chr         , Chr         , Mm          , Mm          , Mm^Xm       , Mm          , Hh          , Gg          , Hh          , Gg          , Gg          , Gg          
Gs^Fp       , Gs^Fp       , Gs^Fp       , Gs^Fp       , Gg^Fet      , Gs^Fms      , Gs^Fp       , Gs^Fp       , Gs^Fp       , Gs^Fp       , Gg^Efm      , Gg^Efm      , Gg^Efm      , Gs          , Gg^Efm      , Hh          , Hh          , Mm          , Mm          , Hh^Fds      , Ha^Fpa      , Mm          , Kh          , Hh^Fmw      , Hh          , Gg^Efm      , Gg          , Gg^Efm      , Gg          , Mm          , Hh          , Hh          , Gg^Efm      , Gg^Efm      , Gg^Efm      , Hh          , Hh          , Hh^Fp       , Chr         , Khr         , Mm          , Mm          , Mm^Xm       , Ms          , Hh          , Gg          , Gg          , Gg          , Gg^Efm      , Gg          
Gs^Fp       , Gs^Fms      , Gs^Fp       , Gs^Fp       , Gs^Fp       , Gs^Fms      , Gs^Fp       , Gg^Ve       , Gs^Fp       , Gg^Efm      , Gg^Efm      , Gg^Efm      , Gs^Fms      , Gs^Fms      , Gg^Efm      , Gs^Fp       , Hh          , Hh^Vhh      , Hh          , Mm          , Ms          , Hh^Fdw      , Chr         , Chr         , Mm          , Gg          , Gg^Efm      , Mm          , Mm          , Mm          , Hh          , Gg^Efm      , Hh          , Mm          , Hh          , Hh          , Hh^Fmf      , Hh^Fp       , Mm          , Mm          , Mm^Xm       , Mm^Xm       , Mm          , Ms          , Mm          , Gg          , Gg          , Gg          , Gg^Efm      , Gg          
Ce          , Gs^Fms      , Gs^Fp       , Gs^Fp       , Gg^Efm      , Gs^Fp       , Gg^Fet      , Gs^Fp       , Gs^Fp       , Gg^Efm      , Gg          , Gg          , Gg^Efm      , Gs^Fms      , Gg^Efm      , Gg^Efm      , Gg^Efm      , Gg^Efm      , Gg^Efm      , Hh          , Mm          , Mm          , Hh          , Chr         , Hh^Fdw      , Gg^Efm      , Gg^Efm      , Gg^Efm      , Wo          , Mm          , Mm          , Mm          , Mm          , Mm          , Hh^Fmw      , Hh          , Mm          , Ha^Vhha     , Mm^Xm       , Mm^Xm       , Mm          , Mm          , Mm          , Hh          , Hh          , Gg          , Hh          , Gg          , Gg^Efm      , Gg          
Gs^Fp       , Gs^Fms      , Gs^Fp       , Gs^Fp       , Gs^Fp       , Gs^Fms      , Gs^Fp       , Gs^Fms      , Gs^Fp       , Gg^Efm      , Gg^Efm      , Gg          , Gg^Efm      , Gs          , Gg^Efm      , Gg^Efm      , Gg^Efm      , Gg^Efm      , Gg^Efm      , Gs^Fp       , Hh^Fms      , Mm          , Mm          , Mm          , Hh          , Mm          , Hh          , Gg^Efm      , Mm          , Mm          , Mm          , Ha          , Mm          , Hh^Fmw      , Mm          , Mm          , Mm          , Mm          , Mm^Xm       , Mm^Xm       , Ms          , Mm          , Hh          , Hh          , Hh^Fdw      , Hh^Vhh      , Hh^Fp       , Hh^Fp       , Gg          , Gg          
Gs^Fp       , Gs^Fp       , Gs^Fp       , Gs^Fp       , Gs^Fms      , Gg^Efm      , Gg^Efm      , Gs^Fp       , Gs^Fp       , Gs^Fp       , Gg^Efm      , Gg^Efm      , Gg^Efm      , Gg          , Gg          , Gg          , Gg          , Gg^Efm      , Gg          , Gg^Efm      , Hh^Fms      , Hh^Fdw      , Mm          , Hh          , Gg^Efm      , Gg^Efm      , Gg^Efm      , Gg^Efm      , Mm          , Mm          , Hh^Fmw      , Mm          , Hh^Fp       , Mm          , Hh          , Mm          , Mm          , Mm^Xm       , Mm^Xm       , Ms          , Mm          , Mm          , Chr         , Hh          , Gg          , Hh^Fp       , Hh^Fdw      , Hh          , Gg          , Gg^Efm      
Gs^Fp       , Gs^Fms      , Gs^Fp       , Gs^Fds      , Gs^Fds      , Gs^Fds      , Gs^Fp       , Gg^Efm      , Gs^Fp       , Gs^Fp       , Gs^Fp       , Gg^Efm      , Gg          , Gg          , Hh          , Gg          , Gg          , Gg          , Gg          , Gg^Efm      , Gg          , Ww          , Mm          , Hh          , Hh^Fms      , Hh          , Hh          , Hh          , Mm          , Hh^Fp       , Hh^Fp       , Hh^Fmw      , Hh^Fmw      , Hh^Fp       , Mm^Xm       , Mm^Xm       , Mm^Xm       , Mm^Xm       , Ms          , Ms          , Mm          , Khr         , Hh          , Hh          , Gg          , Gg          , Gg^Efm      , Gg          , Rp          , Rp          
Gg^Fet      , Gs^Fms      , Gs^Fp       , Gg^Fet      , Gs^Fms      , Gs^Fp       , Hh^Fp       , Hh^Fp       , Hh^Fp       , Hh^Fms      , Chr         , Hh^Fmw      , Mm          , Gg          , Hh          , Hh          , Hh^Fmw      , Gg          , Gg          , Gg^Efm      , Gg^Efm      , Mm          , Rp          , Rp          , Mm          , Hh^Fms      , Mm          , Mm          , Mm          , Hh          , Mm          , Hh          , Mm^Xm       , Mm^Xm       , Ms          , Ms          , Ms          , Ms          , Ms          , Ms          , Mm          , Chr         , Hh^Fdw      , Hh          , Hh          , Gg          , Gg          , Gs^Fmw      , Gg          , Gg          
Gs^Fds      , Gg^Fet      , Gs^Fp       , Gs^Fp       , Ce          , Ce          , Ke          , Hh^Fp       , Mm^Xm       , Mm          , Mm^Xm       , Ms          , Mm          , Mm          , Mm          , Mm          , Mm          , Hh          , Hh          , Gg          , Gg          , Hh^Fms      , Hh^Fms      , Mm          , Mm          , Mm          , Mm          , Mm          , Mm^Xm       , Mm^Xm       , Mm^Xm       , Mm^Xm       , Ms          , Ha          , Ha          , Khr         , Chr         , Mm          , Mm          , Mm          , Hh          , Chr         , Hh          , Hh          , Hh^Fp       , Rp          , Gs^Fmw      , Gs^Fds      , Gg          , Gs^Fds      
Gs^Fms      , Gs^Fp       , 2 Gs^Fp     , Gs^Fp       , Hh^Fp       , Ce          , Mm          , Mm          , Mm^Xm       , Mm^Xm       , Mm          , Mm^Xm       , Mm^Xm       , Mm          , Mm          , Mm          , Mm          , Mm          , Mm          , Mm          , Hh^Fms      , Hh^Fms      , Mm          , Mm          , Mm^Xm       , Mm^Xm       , Mm^Xm       , Mm^Xm       , Ms          , Ms          , Ms          , Ms          , Ha          , Ww          , Mm          , Chr         , Mm          , Chr         , Hh          , Rp          , Mm          , Rp          , Rp          , Hh          , Rp          , Gs^Fp       , Gs^Fp       , Gs^Fds      , Gs^Fds      , Gg^Efm      
Gs^Fp       , Gs^Fms      , 1 Gs^Fp     , Gs^Fp       , Hh^Fp       , Hh^Fp       , Mm          , Mm^Xm       , Mm          , Mm          , Gg^Efm      , Hh^Fp       , Mm          , Mm^Xm       , Mm^Xm       , Mm          , Hh          , Mm^Vhh      , Mm          , Hh^Fms      , Mm          , Mm          , Mm^Xm       , Mm          , Mm^Xm       , Mm          , Mm          , Ha          , Hh^Fmf      , Ms          , Ha          , Ms          , Ha          , Wo          , Gg          , Gg          , Hh          , Rp          , Hh          , Mm          , Mm          , Mm          , Hh^Fdw      , Hh          , Gg          , Gs^Fp       , Gs^Fp       , Gs^Fds      , Gs^Fds      , Gs^Fds      
Gs^Fms      , Gs^Fms      , Hh^Fp       , Gs^Fp       , Hh^Fp       , Mm          , Mm^Xm       , Mm^Xm       , Mm          , Gg^Efm      , Gs^Fp       , Mm^Xm       , Mm^Xm       , Hh^Fp       , Hh          , Mm^Xm       , Mm^Xm       , Mm^Xm       , Mm^Xm       , Mm          , Mm^Xm       , Mm^Xm       , Mm^Xm       , Mm^Xm       , Hh          , Hh          , Gg^Efm      , Hh          , Gg          , Hh          , Hh          , Hh          , Wo          , Wo          , Gg^Efm      , Rp          , Hh^Vhh      , Hh          , Mm          , Mm          , Mm          , Mm          , Hh          , Gg          , Gg          , Gg          , Gg          , Gs^Fp       , Gs^Fp       , Gg^Ve       
Gs^Fp       , Gg^Ve       , Gs^Fp       , Hh^Fp       , Hh^Fp       , Mm^Xm       , Mm          , Mm          , Gg          , Hh          , Gs^Fp       , Mm          , Mm^Xm       , Gg^Efm      , Mm          , Gg^Efm      , Hh          , Hh          , Ms          , Mm^Xm       , Mm^Xm       , Mm          , Gg^Efm      , Hh          , Gg          , Gg          , Wo          , Gg^Efm      , Wwf         , Hh          , Wo          , Wo          , Hh^Fms      , Hh          , Rp          , Hh          , Mm          , Mm          , Hh^Fds      , Mm          , Mm^Xm       , Mm          , Hh^Vhh      , Gg          , Gg          , Gs^Fp       , Gs^Fp       , Gs^Fp       , Gs^Fms      , Gs^Fds      
